{
  "keymapShowTopRow": false,
  "type": "iso",
  "keys": {
    "row1": [
      ["'", "\""],
      ["1", "!"],
      ["2", "@"],
      ["3", "#"],
      ["4", "$"],
      ["5", "%"],
      ["6", "¨"],
      ["7", "&"],
      ["8", "*"],
      ["9", "("],
      ["0", ")"],
      ["-", "_"],
      ["=", "+"]
    ],
    "row2": [
      ["q", "Q"],
      ["w", "W"],
      ["e", "E"],
      ["r", "R"],
      ["t", "T"],
      ["y", "Y"],
      ["u", "U"],
      ["i", "I"],
      ["o", "O"],
      ["p", "P"],
      ["´", "`"],
      ["[", "{"]
    ],
    "row3": [
      ["a", "A"],
      ["s", "S"],
      ["d", "D"],
      ["f", "F"],
      ["g", "G"],
      ["h", "H"],
      ["j", "J"],
      ["k", "K"],
      ["l", "L"],
      ["ç", "Ç"],
      ["~", "^"],
      ["]", "}"]
    ],
    "row4": [
      ["|"],
      ["z", "Z"],
      ["x", "X"],
      ["c", "C"],
      ["v", "V"],
      ["b", "B"],
      ["n", "N"],
      ["m", "M"],
      [",", "<"],
      [".", ">"],
      ["/", "?"]
    ],
    "row5": [[" "]]
  }
}
