{
  "keymapShowTopRow": false,
  "type": "ansi",
  "keys": {
    "row1": [
      ["§", "±"],
      ["1", "!"],
      ["2", "@"],
      ["3", "#"],
      ["4", "$"],
      ["5", "%"],
      ["6", "^"],
      ["7", "&"],
      ["8", "*"],
      ["9", "("],
      ["0", ")"],
      ["-", "_"],
      ["=", "+"]
    ],
    "row2": [
      ["ض", "َ"],
      ["ص", "ً"],
      ["ث", "ِ"],
      ["ق", "ٍ"],
      ["ف", "ُ"],
      ["غ", "ٌ"],
      ["ع", "ْ"],
      ["ه", "ّ"],
      ["خ", "]"],
      ["ح", "["],
      ["ج", "}"],
      ["ة", "{"],
      ["\\", "|"]
    ],
    "row3": [
      ["ش", "«"],
      ["س", "»"],
      ["ي", "ى"],
      ["ب"],
      ["ل"],
      ["ا", "آ"],
      ["ت"],
      ["ن", "٫"],
      ["م", "٬"],
      ["ك", ":"],
      ["؛", "\""]
    ],
    "row4": [
      ["ظ", "'"],
      ["ط"],
      ["ذ", "ئ"],
      ["د", "ء"],
      ["ز", "أ"],
      ["ر", "إ"],
      ["و", "ؤ"],
      ["،", ">"],
      [".", "<"],
      ["/", "؟"]
    ],
    "row5": [[" "]]
  }
}
