{
  "keymapShowTopRow": false,
  "type": "ansi",
  "keys": {
    "row1": [
      ["`", "~"],
      ["1", "!"],
      ["2", "@"],
      ["3", "#"],
      ["4", "$"],
      ["5", "%"],
      ["6", "^"],
      ["7", "&"],
      ["8", "*"],
      ["9", "("],
      ["0", ")"],
      ["-", "_"],
      ["=", "+"]
    ],
    "row2": [
      ["w", "W"],
      ["l", "L"],
      ["y", "Y"],
      ["p", "P"],
      ["k", "K"],
      ["z", "Z"],
      ["x", "X"],
      ["o", "O"],
      ["u", "U"],
      [";", ":"],
      ["[", "{"],
      ["]", "}"],
      ["\\", "|"]
    ],
    "row3": [
      ["c", "C"],
      ["r", "R"],
      ["s", "S"],
      ["t", "T"],
      ["b", "B"],
      ["f", "F"],
      ["n", "N"],
      ["e", "E"],
      ["i", "I"],
      ["a", "A"],
      ["'", "\""]
    ],
    "row4": [
      ["j", "J"],
      ["v", "V"],
      ["d", "D"],
      ["g", "G"],
      ["q", "Q"],
      ["m", "M"],
      ["h", "H"],
      ["/", "?"],
      [",", "<"],
      [".", ">"]
    ],
    "row5": [[" "]]
  }
}
