{
  "keymapShowTopRow": false,
  "type": "ansi",
  "keys": {
    "row1": [
      ["`", "~"],
      ["1", "!"],
      ["2", "@"],
      ["3", "#"],
      ["4", "$"],
      ["5", "%"],
      ["6", "^"],
      ["7", "&"],
      ["8", "*"],
      ["9", "("],
      ["0", ")"],
      ["[", "{"],
      ["]", "}"]
    ],
    "row2": [
      ["w", "W"],
      ["c", "C"],
      ["d", "D"],
      ["l", "L"],
      ["k", "K"],
      ["j", "J"],
      ["/", "?"],
      ["u", "U"],
      ["o", "O"],
      ["y", "Y"],
      [";", ":"],
      ["=", "+"],
      ["\\", "|"]
    ],
    "row3": [
      ["r", "R"],
      ["s", "S"],
      ["t", "T"],
      ["h", "H"],
      ["v", "V"],
      ["b", "B"],
      ["n", "N"],
      ["e", "E"],
      ["a", "A"],
      ["i", "I"],
      [".", "<"]
    ],
    "row4": [
      ["q", "Q"],
      ["z", "Z"],
      ["g", "G"],
      ["m", "M"],
      ["x", "X"],
      ["p", "P"],
      ["f", "F"],
      ["'", "\""],
      [",", ">"],
      ["-", "_"]
    ],
    "row5": [[" "]]
  }
}
