{
  "keymapShowTopRow": true,
  "type": "ansi",
  "keys": {
    "row1": [
      ["`", "~"],
      ["1", "!"],
      ["2", "@"],
      ["3", "#"],
      ["4", "$"],
      ["j", "J"],
      ["l", "L"],
      ["m", "M"],
      ["f", "F"],
      ["p", "P"],
      ["/", "?"],
      ["[", "{"],
      ["]", "}"]
    ],
    "row2": [
      ["5", "%"],
      ["6", "^"],
      ["q", "Q"],
      [".", ">"],
      ["o", "O"],
      ["r", "R"],
      ["s", "S"],
      ["u", "U"],
      ["y", "Y"],
      ["b", "B"],
      [";", ":"],
      ["=", "+"],
      ["\\", "|"]
    ],
    "row3": [
      ["7", "&"],
      ["8", "*"],
      ["z", "Z"],
      ["a", "A"],
      ["e", "E"],
      ["h", "H"],
      ["t", "T"],
      ["d", "D"],
      ["c", "C"],
      ["k", "K"],
      ["-", "_"]
    ],
    "row4": [
      ["9", "("],
      ["0", ")"],
      ["x", "X"],
      [",", "<"],
      ["i", "I"],
      ["n", "N"],
      ["w", "W"],
      ["v", "V"],
      ["g", "G"],
      ["'", "\""]
    ],
    "row5": [[" "]]
  }
}
