{
  "keymapShowTopRow": false,
  "type": "ansi",
  "keys": {
    "row1": [
      ["`", "~"],
      ["1", "!"],
      ["2", "@"],
      ["3", "#"],
      ["4", "$"],
      ["5", "%"],
      ["6", "^"],
      ["7", "&"],
      ["8", "*"],
      ["9", "("],
      ["0", ")"],
      ["-", "_"],
      ["=", "+"]
    ],
    "row2": [
      ["b", "B"],
      ["x", "X"],
      [".", ">"],
      ["w", "W"],
      ["v", "V"],
      ["z", "Z"],
      ["/", "?"],
      ["u", "U"],
      ["t", "T"],
      ["k", "K"],
      ["[", "{"],
      ["]", "}"],
      ["\\", "|"]
    ],
    "row3": [
      ["f", "F"],
      ["o", "O"],
      ["a", "A"],
      ["l", "L"],
      ["s", "S"],
      ["n", "N"],
      ["e", "E"],
      ["i", "I"],
      ["g", "G"],
      ["h", "H"],
      [";", ":"]
    ],
    "row4": [
      ["p", "P"],
      ["'", "\""],
      [".", ">"],
      ["m", "M"],
      ["c", "C"],
      ["q", "Q"],
      ["j", "J"],
      ["y", "Y"],
      ["d", "D"],
      ["r", "R"]
    ],
    "row5": [[" "]]
  }
}
