{
  "keymapShowTopRow": true,
  "type": "ansi",
  "keys": {
    "row1": [
      ["ろ", "ろ"],
      ["ぬ", "ぬ"],
      ["ふ", "ふ"],
      ["あ", "ぁ"],
      ["う", "ぅ"],
      ["え", "ぇ"],
      ["お", "ぉ"],
      ["や", "ゃ"],
      ["ゆ", "ゅ"],
      ["よ", "ょ"],
      ["わ", "を"],
      ["ほ", "ほ"],
      ["へ", "へ"]
    ],
    "row2": [
      ["た", "た"],
      ["て", "て"],
      ["い", "ぃ"],
      ["す", "す"],
      ["か", "か"],
      ["ん", "ん"],
      ["な", "な"],
      ["に", "に"],
      ["ら", "ら"],
      ["せ", "せ"],
      ["゛", "「"],
      ["゜", "」"],
      ["む", "む"]
    ],
    "row3": [
      ["ち", "ち"],
      ["と", "と"],
      ["し", "し"],
      ["は", "は"],
      ["き", "き"],
      ["く", "く"],
      ["ま", "ま"],
      ["の", "の"],
      ["り", "り"],
      ["れ", "れ"],
      ["け", "け"]
    ],
    "row4": [
      ["つ", "っ"],
      ["さ", "さ"],
      ["そ", "そ"],
      ["ひ", "ひ"],
      ["こ", "こ"],
      ["み", "み"],
      ["も", "も"],
      ["ね", "、"],
      ["る", "。"],
      ["め", "・"]
    ],
    "row5": [[" "]]
  }
}
