{
  "keymapShowTopRow": false,
  "type": "ansi",
  "keys": {
    "row1": [
      ["`", "~"],
      ["1", "!"],
      ["2", "@"],
      ["3", "#"],
      ["4", "$"],
      ["5", "%"],
      ["6", "^"],
      ["7", "&"],
      ["8", "*"],
      ["9", "("],
      ["0", ")"],
      ["-", "_"],
      ["=", "+"]
    ],
    "row2": [
      ["k", "K"],
      [",", "<"],
      ["u", "U"],
      ["y", "Y"],
      ["p", "P"],
      ["w", "W"],
      ["l", "L"],
      ["m", "M"],
      ["f", "F"],
      ["c", "C"],
      ["[", "{"],
      ["]", "}"],
      ["\\", "|"]
    ],
    "row3": [
      ["o", "O"],
      ["a", "A"],
      ["e", "E"],
      ["i", "I"],
      ["d", "D"],
      ["r", "R"],
      ["n", "N"],
      ["t", "T"],
      ["h", "H"],
      ["s", "S"],
      ["'", "\""]
    ],
    "row4": [
      ["q", "Q"],
      [".", ">"],
      ["'", "\""],
      [";", ":"],
      ["z", "Z"],
      ["x", "X"],
      ["v", "V"],
      ["g", "G"],
      ["b", "B"],
      ["j", "J"]
    ],
    "row5": [[" "]]
  }
}
