{
  "keymapShowTopRow": false,
  "type": "ansi",
  "keys": {
    "row1": [
      ["`", "~"],
      ["1", "!"],
      ["2", "@"],
      ["3", "#"],
      ["4", "$"],
      ["5", "%"],
      ["6", "^"],
      ["7", "&"],
      ["8", "*"],
      ["9", "("],
      ["0", ")"],
      ["-", "_"],
      ["=", "+"]
    ],
    "row2": [
      ["j", "J"],
      ["o", "O"],
      ["u", "U"],
      ["r", "R"],
      ["q", "Q"],
      ["v", "V"],
      ["d", "D"],
      ["l", "L"],
      ["b", "B"],
      ["g", "G"],
      ["[", "{"],
      ["]", "}"],
      ["\\", "|"]
    ],
    "row3": [
      ["e", "E"],
      ["a", "A"],
      ["i", "I"],
      ["n", "N"],
      ["x", "X"],
      ["y", "Y"],
      ["h", "H"],
      ["t", "T"],
      ["s", "S"],
      ["c", "C"],
      ["'", "\""]
    ],
    "row4": [
      ["/", "?"],
      [".", ">"],
      [",", "<"],
      [";", ":"],
      ["z", "Z"],
      ["k", "K"],
      ["p", "P"],
      ["m", "M"],
      ["f", "F"],
      ["w", "W"]
    ],
    "row5": [[" "]]
  }
}
