{
  "keymapShowTopRow": false,
  "type": "ansi",
  "keys": {
    "row1": [
      ["`", "~"],
      ["1", "!"],
      ["2", "@"],
      ["3", "#"],
      ["4", "$"],
      ["5", "%"],
      ["6", "^"],
      ["7", "&"],
      ["8", "*"],
      ["9", "("],
      ["0", ")"],
      ["-", "_"],
      ["=", "+"]
    ],
    "row2": [
      ["v", "V"],
      ["w", "W"],
      ["l", "L"],
      ["y", "Y"],
      ["k", "K"],
      ["j", "J"],
      ["f", "F"],
      ["o", "O"],
      ["u", "U"],
      [".", ">"],
      [",", "<"],
      ["[", "{"],
      ["]", "}"]
    ],
    "row3": [
      ["c", "C"],
      ["r", "R"],
      ["s", "S"],
      ["t", "T"],
      ["p", "P"],
      ["b", "B"],
      ["n", "N"],
      ["a", "A"],
      ["e", "E"],
      ["i", "I"],
      ["/", "?"]
    ],
    "row4": [
      ["z", "Z"],
      ["x", "X"],
      ["d", "D"],
      ["g", "G"],
      ["q", "Q"],
      ["m", "M"],
      ["h", "H"],
      ["'", "\""],
      [";", ":"],
      ["\\", "|"]
    ],
    "row5": [[" "]]
  }
}
