{
  "keymapShowTopRow": false,
  "type": "ansi",
  "keys": {
    "row1": [
      ["`", "~"],
      ["1", "!"],
      ["2", "@"],
      ["3", "#"],
      ["4", "$"],
      ["5", "%"],
      ["6", "^"],
      ["7", "&"],
      ["8", "*"],
      ["9", "("],
      ["0", ")"],
      ["-", "_"],
      ["=", "+"]
    ],
    "row2": [
      ["f", "F"],
      ["d", "D"],
      ["l", "L"],
      ["b", "B"],
      ["v", "V"],
      ["j", "J"],
      ["g", "G"],
      ["o", "O"],
      ["u", "U"],
      [",", "<"],
      ["[", "{"],
      ["]", "}"],
      ["\\", "|"]
    ],
    "row3": [
      ["s", "S"],
      ["t", "T"],
      ["r", "R"],
      ["n", "N"],
      ["k", "K"],
      ["y", "Y"],
      ["m", "M"],
      ["a", "A"],
      ["e", "E"],
      ["i", "I"],
      ["/", "?"]
    ],
    "row4": [
      ["z", "Z"],
      ["q", "Q"],
      ["x", "X"],
      ["h", "H"],
      ["p", "P"],
      ["w", "W"],
      ["c", "C"],
      ["'", "\""],
      [";", ":"],
      [".", ">"]
    ],
    "row5": [[" "]]
  }
}
