{
  "keymapShowTopRow": false,
  "type": "ansi",
  "keys": {
    "row1": [
      ["`", "~"],
      ["1", "!"],
      ["2", "@"],
      ["3", "#"],
      ["4", "$"],
      ["5", "%"],
      ["6", "^"],
      ["7", "&"],
      ["8", "*"],
      ["9", "("],
      ["0", ")"],
      ["-", "_"],
      ["=", "+"]
    ],
    "row2": [
      ["f", "F"],
      ["l", "L"],
      ["h", "H"],
      ["d", "D"],
      ["v", "V"],
      ["z", "Z"],
      ["g", "G"],
      ["o", "O"],
      ["u", "U"],
      [".", ">"],
      ["[", "{"],
      ["]", "}"],
      ["\\", "|"]
    ],
    "row3": [
      ["s", "S"],
      ["r", "R"],
      ["n", "N"],
      ["t", "T"],
      ["m", "M"],
      ["p", "P"],
      ["y", "Y"],
      ["e", "E"],
      ["i", "I"],
      ["a", "A"],
      ["/", "?"]
    ],
    "row4": [
      ["x", "X"],
      ["j", "J"],
      ["b", "B"],
      ["k", "K"],
      ["q", "Q"],
      ["c", "C"],
      ["w", "W"],
      ["'", "\""],
      [",", "<"],
      [";", ":"]
    ],
    "row5": [[" "]]
  }
}
