{
  "keymapShowTopRow": false,
  "type": "iso",
  "keys": {
    "row1": [
      ["^", "ˇ"],
      ["1", "°"],
      ["2", "§"],
      ["3", "ℓ"],
      ["4", "»"],
      ["5", "«"],
      ["6", "$"],
      ["7", "€"],
      ["8", "„"],
      ["9", "“"],
      ["0", "”"],
      ["-", "—"],
      ["`", "¸"]
    ],
    "row2": [
      ["k", "K"],
      ["u", "U"],
      ["ü", "Ü"],
      [".", "•"],
      ["ä", "Ä"],
      ["v", "V"],
      ["g", "G"],
      ["c", "C"],
      ["l", "L"],
      ["j", "J"],
      ["f", "F"],
      ["'", "~"]
    ],
    "row3": [
      ["h", "H"],
      ["i", "I"],
      ["e", "E"],
      ["a", "A"],
      ["o", "O"],
      ["d", "D"],
      ["t", "T"],
      ["r", "R"],
      ["n", "N"],
      ["s", "S"],
      ["ß", "ẞ"],
      [" "]
    ],
    "row4": [
      [" "],
      ["x", "X"],
      ["y", "Y"],
      ["ö", "Ö"],
      [",", "–"],
      ["q", "Q"],
      ["b", "B"],
      ["p", "P"],
      ["w", "W"],
      ["m", "M"],
      ["z", "Z"]
    ],
    "row5": [[" "]]
  }
}
