{
  "keymapShowTopRow": false,
  "type": "ansi",
  "keys": {
    "row1": [
      ["`", "~"],
      ["1", "!"],
      ["2", "@"],
      ["3", "#"],
      ["4", "$"],
      ["5", "%"],
      ["6", "^"],
      ["7", "&"],
      ["8", "*"],
      ["9", "("],
      ["0", ")"],
      ["-", "_"],
      ["=", "+"]
    ],
    "row2": [
      ["a", "A"],
      ["b", "B"],
      ["c", "C"],
      ["d", "D"],
      ["e", "E"],
      ["f", "F"],
      ["g", "G"],
      ["h", "H"],
      ["i", "I"],
      ["j", "J"],
      ["[", "{"],
      ["]", "}"],
      ["\\", "|"]
    ],
    "row3": [
      ["k", "K"],
      ["l", "L"],
      ["m", "M"],
      ["n", "N"],
      ["o", "O"],
      ["p", "P"],
      ["q", "Q"],
      ["r", "R"],
      ["s", "S"],
      [";", ":"],
      ["'", "\""]
    ],
    "row4": [
      ["t", "T"],
      ["u", "U"],
      ["v", "V"],
      ["w", "W"],
      ["x", "X"],
      ["y", "Y"],
      ["z", "Z"],
      [",", "<"],
      [".", ">"],
      ["/", "?"]
    ],
    "row5": [[" "]]
  }
}
