{
  "keymapShowTopRow": false,
  "type": "ansi",
  "keys": {
    "row1": [
      ["`", "~"],
      ["1", "!"],
      ["2", "@"],
      ["3", "#"],
      ["4", "$"],
      ["5", "%"],
      ["6", "^"],
      ["7", "&"],
      ["8", "*"],
      ["9", "("],
      ["0", ")"],
      ["-", "_"],
      ["=", "+"]
    ],
    "row2": [
      ["q", "Q"],
      ["l", "L"],
      ["u", "U"],
      ["c", "C"],
      ["j", "J"],
      ["k", "K"],
      ["p", "P"],
      ["m", "M"],
      ["w", "W"],
      [";", ":"],
      ["[", "{"],
      ["]", "}"],
      ["\\", "|"]
    ],
    "row3": [
      ["a", "A"],
      ["n", "N"],
      ["i", "I"],
      ["s", "S"],
      ["v", "V"],
      ["b", "B"],
      ["h", "H"],
      ["t", "T"],
      ["r", "R"],
      ["o", "O"],
      ["'", "\""]
    ],
    "row4": [
      [",", "<"],
      [".", ">"],
      ["y", "Y"],
      ["g", "G"],
      ["x", "X"],
      ["z", "Z"],
      ["f", "F"],
      ["d", "D"],
      ["'", "\""],
      ["-", "_"]
    ],
    "row5": [["e", "E"], [" "]]
  }
}
