{
  "keymapShowTopRow": false,
  "type": "ansi",
  "keys": {
    "row1": [
      ["`", "~"],
      ["1", "!"],
      ["2", "@"],
      ["3", "#"],
      ["4", "$"],
      ["5", "%"],
      ["6", "^"],
      ["7", "&"],
      ["8", "*"],
      ["9", "("],
      ["0", ")"],
      ["-", "_"],
      ["=", "+"]
    ],
    "row2": [
      ["w", "W"],
      ["g", "G"],
      ["d", "D"],
      ["f", "F"],
      ["b", "B"],
      ["q", "Q"],
      ["l", "L"],
      ["u", "U"],
      ["o", "O"],
      ["y", "Y"],
      ["[", "{"],
      ["]", "}"],
      ["\\", "|"]
    ],
    "row3": [
      ["r", "R"],
      ["s", "S"],
      ["t", "T"],
      ["h", "H"],
      ["k", "K"],
      ["j", "J"],
      ["n", "N"],
      ["e", "E"],
      ["a", "A"],
      ["i", "I"],
      [";", ":"]
    ],
    "row4": [
      ["c", "C"],
      ["m", "M"],
      ["p", "P"],
      ["v", "V"],
      ["x", "X"],
      ["z", "Z"],
      [",", "<"],
      [".", ">"],
      ["'", "\""],
      ["/", "?"]
    ],
    "row5": [[" "]]
  }
}
