{
  "keymapShowTopRow": false,
  "type": "ansi",
  "keys": {
    "row1": [
      ["`", "~"],
      ["1", "!"],
      ["2", "@"],
      ["3", "#"],
      ["4", "$"],
      ["5", "%"],
      ["6", "^"],
      ["7", "&"],
      ["8", "*"],
      ["9", "("],
      ["0", ")"],
      ["-", "_"],
      ["=", "+"]
    ],
    "row2": [
      ["w", "W"],
      ["c", "C"],
      ["d", "D"],
      ["l", "L"],
      ["k", "K"],
      ["j", "J"],
      ["y", "Y"],
      ["o", "O"],
      ["u", "U"],
      ["/", "?"],
      ["[", "{"],
      ["]", "}"],
      ["\\", "|"]
    ],
    "row3": [
      ["r", "R"],
      ["s", "S"],
      ["t", "T"],
      ["h", "H"],
      ["v", "V"],
      ["p", "P"],
      ["n", "N"],
      ["e", "E"],
      ["a", "A"],
      ["i", "I"],
      [";", ":"]
    ],
    "row4": [
      ["q", "Q"],
      ["b", "B"],
      ["g", "G"],
      ["m", "M"],
      ["x", "X"],
      ["z", "Z"],
      ["f", "F"],
      ["'", "\""],
      [",", "<"],
      [".", ">"]
    ],
    "row5": [[" "]]
  }
}
