{
  "keymapShowTopRow": false,
  "type": "ansi",
  "keys": {
    "row1": [
      [">", "<"],
      ["1", "!"],
      ["2", "@"],
      ["3", "#"],
      ["4", "$"],
      ["5", "%"],
      ["6", "^"],
      ["7", "&"],
      ["8", "*"],
      ["9", ")"],
      ["0", "("],
      ["-", "_"],
      ["=", "+"]
    ],
    "row2": [
      ["ض", "َ"],
      ["ص", "ً"],
      ["ث", "ُ"],
      ["ق", "ٌ"],
      ["ف", "ﻹ"],
      ["غ", "إ"],
      ["ع", "‘"],
      ["ه", "÷"],
      ["خ", "×"],
      ["ح", "؛"],
      ["ج", "}"],
      ["د", "{"],
      ["ذ", "ّ"]
    ],
    "row3": [
      ["ش", "\\"],
      ["س", "​"],
      ["ي", "]"],
      ["ب", "["],
      ["ل", "ﻷ"],
      ["ا", "أ"],
      ["ت", "ـ"],
      ["ن", "،"],
      ["م", "/"],
      ["ك", ":"],
      ["ط", "\""]
    ],
    "row4": [
      ["ئ", "~"],
      ["ء", "ْ"],
      ["ؤ", "ِ"],
      ["ر", "ٍ"],
      ["ﻻ", "ﻵ"],
      ["ى", "آ"],
      ["ة", "’"],
      ["و", ","],
      ["ز", "."],
      ["ظ", "؟"]
    ],
    "row5": [[" "]]
  }
}
