{
  "keymapShowTopRow": false,
  "type": "ansi",
  "keys": {
    "row1": [
      ["`", "~"],
      ["1", "!"],
      ["2", "@"],
      ["3", "#"],
      ["4", "$"],
      ["5", "%"],
      ["6", "^"],
      ["7", "&"],
      ["8", "*"],
      ["9", "("],
      ["0", ")"],
      ["-", "_"],
      ["=", "+"]
    ],
    "row2": [
      ["q", "Q"],
      ["l", "L"],
      [".", ">"],
      ["p", "P"],
      ["'", "\""],
      [";", ":"],
      ["f", "F"],
      ["u", "U"],
      ["d", "D"],
      ["k", "K"],
      ["[", "{"],
      ["]", "}"],
      ["\\", "|"]
    ],
    "row3": [
      ["a", "A"],
      ["r", "R"],
      ["e", "E"],
      ["n", "N"],
      ["b", "B"],
      ["g", "G"],
      ["s", "S"],
      ["i", "I"],
      ["t", "T"],
      ["o", "O"],
      ["/", "?"]
    ],
    "row4": [
      ["z", "Z"],
      ["w", "W"],
      [",", "<"],
      ["h", "H"],
      ["j", "J"],
      ["v", "V"],
      ["c", "C"],
      ["y", "Y"],
      ["m", "M"],
      ["x", "X"]
    ],
    "row5": [[" "]]
  }
}
