{
  "keymapShowTopRow": false,
  "type": "ansi",
  "keys": {
    "row1": [
      ["`", "~", "`", "~"],
      ["1", "!", "՜", "★"],
      ["2", "@", "™", "€"],
      ["3", "#", "£", "№"],
      ["4", "$", "¢"],
      ["5", "%", "★"],
      ["6", "^", "§"],
      ["7", "&", "¶"],
      ["8", "*", "•", "°"],
      ["9", "(", "«", "‹"],
      ["0", ")", "»", "›"],
      ["-", "_", "–", "—"],
      ["=", "+", "≠", "±"]
    ],
    "row2": [
      ["ճ", "Ճ", "չ", "Չ"],
      ["ւ", "Ւ"],
      ["ե", "Ե", "է", "Է"],
      ["ր", "Ր", "ռ", "Ռ"],
      ["տ", "Տ", "թ", "Թ"],
      ["յ", "Յ", "†", "¥"],
      ["ւ", "Ւ", "÷", "՚"],
      ["ի", "Ի", "„", "„"],
      ["ո", "Ո", "օ", "Օ"],
      ["պ", "Պ", "փ", "Փ"],
      ["[", "{", "“", "”"],
      ["]", "}", "‘", "’"],
      ["\\", "|", "«", "»"]
    ],
    "row3": [
      ["ա", "Ա", "ը", "Ը"],
      ["ս", "Ս", "շ", "Շ"],
      ["դ", "Դ"],
      ["ֆ", "Ֆ", "ƒ"],
      ["գ", "Գ", "©", "®"],
      ["հ", "Հ"],
      ["ձ", "Ձ", "ջ", "Ջ"],
      ["կ", "Կ", "ք", "Ք"],
      ["լ", "Լ", "ղ", "Ղ"],
      [";", ":", "…", "՟"],
      ["'", "\"", "՛", "֊"]
    ],
    "row4": [
      ["զ", "Զ", "ժ", "Ժ"],
      ["խ", "Խ"],
      ["ծ", "Ծ", "ց", "Ց"],
      ["վ", "Վ", "և"],
      ["բ", "Բ"],
      ["ն", "Ն"],
      ["մ", "Մ"],
      [",", "<", "՝", "≤"],
      [".", ">", "։", "≥"],
      ["/", "?", "՞", "՞"]
    ],
    "row5": [[" "]]
  }
}
