{
  "keymapShowTopRow": false,
  "type": "ansi",
  "keys": {
    "row1": [
      ["`", "~"],
      ["1", "!"],
      ["2", "@"],
      ["3", "#"],
      ["4", "$"],
      ["5", "%"],
      ["6", "^"],
      ["7", "&"],
      ["8", "*"],
      ["9", "("],
      ["0", ")"],
      ["-", "_"],
      ["=", "+"]
    ],
    "row2": [
      ["q", "Q"],
      ["l", "L"],
      ["d", "D"],
      ["y", "Y"],
      ["g", "G"],
      ["j", "J"],
      ["m", "M"],
      ["o", "O"],
      ["u", "U"],
      [";", ":"],
      ["[", "{"],
      ["]", "}"],
      ["\\", "|"]
    ],
    "row3": [
      ["a", "A"],
      ["r", "R"],
      ["t", "T"],
      ["s", "S"],
      ["c", "C"],
      ["p", "P"],
      ["n", "N"],
      ["e", "E"],
      ["i", "I"],
      ["h", "H"],
      ["/", "?"]
    ],
    "row4": [
      ["z", "Z"],
      ["x", "X"],
      ["k", "K"],
      ["w", "W"],
      ["v", "V"],
      ["b", "B"],
      ["f", "F"],
      ["'", "\""],
      [",", "<"],
      [".", ">"]
    ],
    "row5": [[" "]]
  }
}
