{
  "keymapShowTopRow": false,
  "type": "ansi",
  "keys": {
    "row1": [
      ["`", "~"],
      ["1", "!"],
      ["2", "@"],
      ["3", "#"],
      ["4", "$"],
      ["5", "%"],
      ["6", "^"],
      ["7", "&"],
      ["8", "*"],
      ["9", "("],
      ["0", ")"],
      ["-", "_"],
      ["=", "+"]
    ],
    "row2": [
      ["q", "Q"],
      ["y", "Y"],
      ["o", "O"],
      ["u", "U"],
      ["z", "Z"],
      ["w", "W"],
      ["d", "D"],
      ["n", "N"],
      ["c", "C"],
      ["k", "K"],
      ["[", "{"],
      ["]", "}"],
      ["\\", "|"]
    ],
    "row3": [
      ["h", "H"],
      ["i", "I"],
      ["e", "E"],
      ["a", "A"],
      [",", "<"],
      ["g", "G"],
      ["t", "T"],
      ["r", "R"],
      ["s", "S"],
      ["p", "P"],
      [";", ":"]
    ],
    "row4": [
      ["j", "J"],
      ["'", "\""],
      ["/", "?"],
      [".", ">"],
      ["x", "X"],
      ["v", "V"],
      ["m", "M"],
      ["l", "L"],
      ["f", "F"],
      ["b", "B"]
    ],
    "row5": [[" "]]
  }
}
