{
  "keymapShowTopRow": false,
  "type": "ansi",
  "keys": {
    "row1": [
      ["`", "~"],
      ["1", "!"],
      ["2", "@"],
      ["3", "#"],
      ["4", "$"],
      ["5", "%"],
      ["6", "^"],
      ["7", "&"],
      ["8", "*"],
      ["9", "("],
      ["0", ")"],
      ["-", "_"],
      ["=", "+"]
    ],
    "row2": [
      ["q", "Q"],
      ["h", "H"],
      ["o", "O"],
      ["u", "U"],
      ["x", "X"],
      ["g", "G"],
      ["c", "C"],
      ["r", "R"],
      ["f", "F"],
      ["z", "Z"],
      ["[", "{"],
      ["]", "}"],
      ["\\", "|"]
    ],
    "row3": [
      ["y", "Y"],
      ["i", "I"],
      ["e", "E"],
      ["a", "A"],
      [".", ">"],
      ["d", "D"],
      ["s", "S"],
      ["t", "T"],
      ["n", "N"],
      ["b", "B"],
      [";", ":"]
    ],
    "row4": [
      ["j", "J"],
      ["/", "?"],
      [",", "<"],
      ["k", "K"],
      ["'", "\""],
      ["w", "W"],
      ["m", "M"],
      ["l", "L"],
      ["p", "P"],
      ["v", "V"]
    ],
    "row5": [[" "]]
  }
}
