{
  "keymapShowTopRow": false,
  "type": "ansi",
  "keys": {
    "row1": [
      ["`", "~"],
      ["1", "!"],
      ["2", "@"],
      ["3", "#"],
      ["4", "$"],
      ["5", "%"],
      ["6", "^"],
      ["7", "&"],
      ["8", "*"],
      ["9", "("],
      ["0", ")"],
      ["-", "_"],
      ["=", "+"]
    ],
    "row2": [
      ["q", "Q"],
      [".", ">"],
      ["o", "O"],
      ["u", "U"],
      ["j", "J"],
      ["w", "W"],
      ["d", "D"],
      ["n", "N"],
      ["m", "M"],
      [",", "<"],
      ["[", "{"],
      ["]", "}"],
      ["\\", "|"]
    ],
    "row3": [
      ["h", "H"],
      ["a", "A"],
      ["e", "E"],
      ["i", "I"],
      ["k", "K"],
      ["g", "G"],
      ["s", "S"],
      ["r", "R"],
      ["t", "T"],
      ["p", "P"],
      [";", ":"]
    ],
    "row4": [
      ["z", "Z"],
      ["'", "\""],
      ["/", "?"],
      ["y", "Y"],
      ["x", "X"],
      ["b", "B"],
      ["c", "C"],
      ["l", "L"],
      ["f", "F"],
      ["v", "V"]
    ],
    "row5": [[" "]]
  }
}
