{
  "keymapShowTopRow": false,
  "type": "ansi",
  "keys": {
    "row1": [
      ["`", "~"],
      ["1", "!"],
      ["2", "@"],
      ["3", "#"],
      ["4", "$"],
      ["5", "%"],
      ["6", "^"],
      ["7", "&"],
      ["8", "*"],
      ["9", "("],
      ["0", ")"],
      ["-", "_"],
      ["=", "+"]
    ],
    "row2": [
      ["z", "Z"],
      ["y", "Y"],
      ["o", "O"],
      ["u", "U"],
      [";", ":"],
      ["g", "G"],
      ["d", "D"],
      ["n", "N"],
      ["m", "M"],
      ["x", "X"],
      ["[", "{"],
      ["]", "}"],
      ["\\", "|"]
    ],
    "row3": [
      ["q", "Q"],
      ["h", "H"],
      ["e", "E"],
      ["a", "A"],
      [".", ">"],
      ["c", "C"],
      ["t", "T"],
      ["r", "R"],
      ["s", "S"],
      ["w", "W"],
      ["'", "\""]
    ],
    "row4": [
      ["j", "J"],
      ["-", "_"],
      ["'", "\""],
      ["k", "K"],
      [",", "<"],
      ["b", "B"],
      ["p", "P"],
      ["l", "L"],
      ["f", "F"],
      ["v", "V"]
    ],
    "row5": [["i", "I"], [" "]]
  }
}
