{
  "keymapShowTopRow": false,
  "type": "ansi",
  "keys": {
    "row1": [
      ["ё", "Ё"],
      ["1", "!"],
      ["2", "\""],
      ["3", "№"],
      ["4", ";"],
      ["5", "%"],
      ["6", ":"],
      ["7", "?"],
      ["8", "*"],
      ["9", "("],
      ["0", ")"],
      ["-", "_"],
      ["=", "+"]
    ],
    "row2": [
      ["й", "Й"],
      ["ц", "Ц"],
      ["у", "У"],
      ["к", "К"],
      ["е", "Е"],
      ["н", "Н"],
      ["г", "Г"],
      ["ш", "Ш"],
      ["ў", "Ў"],
      ["з", "З"],
      ["х", "Х"],
      ["'", "'"],
      ["\\", "/"]
    ],
    "row3": [
      ["ф", "Ф"],
      ["ы", "Ы"],
      ["в", "В"],
      ["а", "А"],
      ["п", "П"],
      ["р", "Р"],
      ["о", "О"],
      ["л", "Л"],
      ["д", "Д"],
      ["ж", "Ж"],
      ["э", "Э"]
    ],
    "row4": [
      ["я", "Я"],
      ["ч", "Ч"],
      ["с", "С"],
      ["м", "М"],
      ["і", "І"],
      ["т", "Т"],
      ["ь", "Ь"],
      ["б", "Б"],
      ["ю", "Ю"],
      [".", ","]
    ],
    "row5": [[" "]]
  }
}
