{
  "keymapShowTopRow": false,
  "type": "iso",
  "keys": {
    "row1": [
      ["$", "#", "–", "¶"],
      ["\"", "1", "—", "„"],
      ["«", "2", "<", "“"],
      ["»", "3", ">", "”"],
      ["(", "4", "[", "⩽"],
      [")", "5", "]", "⩾"],
      ["@", "6", "^"],
      ["+", "7", "±", "¬"],
      ["-", "8", "−", "¼"],
      ["/", "9", "÷", "½"],
      ["*", "0", "×", "¾"],
      ["=", "°", "≠"],
      ["%", "`", "″", "″"]
    ],
    "row2": [
      ["b", "B", "|", "¦"],
      ["é", "É", "ó", "ő"],
      ["p", "P", "&", "§"],
      ["o", "O", "œ", "Œ"],
      ["è", "È", "ò", "`"],
      ["ô", "!", "¡"],
      ["v", "V", "ǒ"],
      ["d", "D", "ð", "Ð"],
      ["l", "L", "ø"],
      ["j", "J", "ĳ", "Ĳ"],
      ["z", "Z", "ə", "Ə"],
      ["w", "W", "ŏ"]
    ],
    "row3": [
      ["a", "A", "æ", "Æ"],
      ["u", "U", "ù", "Ù"],
      ["i", "I", "ö", "ȯ"],
      ["e", "E", "€", "¤"],
      [",", ";", "’", "ǫ"],
      ["c", "C", "©", "ſ"],
      ["t", "T", "þ", "Þ"],
      ["s", "S", "ß", "ẞ"],
      ["r", "R", "®", "™"],
      ["n", "N", "õ"],
      ["m", "M", "ō", "º"],
      ["ç", "Ç", "¸", ","]
    ],
    "row4": [
      ["ê", "Ê", "/"],
      ["à", "À", "\\"],
      ["y", "Y", "{", "‘"],
      ["x", "X", "}", "’"],
      [".", ":", "…", "·"],
      ["k", "K", "~"],
      ["'", "?", "¿", "ỏ"],
      ["q", "Q", "o", "̊"],
      ["g", "G", "Ω"],
      ["h", "H", "†", "‡"],
      ["f", "F", "ǫ", "ª"]
    ],
    "row5": [[" "]]
  }
}
