{
  "keymapShowTopRow": false,
  "type": "iso",
  "keys": {
    "row1": [
      ["$", "#", "–", "¶"],
      ["\"", "1", "—", "„"],
      ["«", "2", "<", "“"],
      ["»", "3", ">", "”"],
      ["(", "4", "[", "⩽"],
      [")", "5", "]", "⩾"],
      ["@", "6", "^"],
      ["+", "7", "±", "¬"],
      ["-", "8", "−", "¼"],
      ["/", "9", "÷", "½"],
      ["*", "0", "×", "¾"],
      ["=", "°", "≠", "′"],
      ["%", "`", "‰", "″"]
    ],
    "row2": [
      ["b", "B", "|", "_"],
      ["é", "É", "ó"],
      ["p", "P", "&", "§"],
      ["o", "O", "œ", "Œ"],
      ["è", "È", "ò", "`"],
      ["ô", "!", "¡"],
      ["v", "V", "ǒ"],
      ["d", "D", "∞"],
      ["l", "L", "ø", "£"],
      ["j", "J"],
      ["z", "Z", "ɵ"],
      ["w", "W"]
    ],
    "row3": [
      ["a", "A", "æ", "Æ"],
      ["u", "U", "ù", "Ù"],
      ["i", "I", "ö", "ȯ"],
      ["e", "E", "€", "¤"],
      [",", ";", "'", "ț"],
      ["c", "C", "¸", "©"],
      ["t", "T", "ᵉ", "™"],
      ["s", "S", "ß", "ſ"],
      ["r", "R", "ŏ", "®"],
      ["n", "N", "õ"],
      ["m", "M", "ō"],
      ["ç", "Ç"]
    ],
    "row4": [
      ["ê", "Ê", "/", "^"],
      ["à", "À", "\\", "‚"],
      ["y", "Y", "{", "‘"],
      ["x", "X", "}", "’"],
      [".", ":", "…", "·"],
      ["k", "K", "~", "‑"],
      ["’", "?", "¿", "ỏ"],
      ["q", "Q", "å", "ơ"],
      ["g", "G", "Ω", "†"],
      ["h", "H", "ọ", "‡"],
      ["f", "F", "ǫ"]
    ],
    "row5": [[" "]]
  }
}
