{
  "keymapShowTopRow": false,
  "type": "iso",
  "keys": {
    "row1": [
      ["^", "ˇ"],
      ["1", "°"],
      ["2", "§"],
      ["3", "ℓ"],
      ["4", "»"],
      ["5", "«"],
      ["6", "$"],
      ["7", "€"],
      ["8", "„"],
      ["9", "“"],
      ["0", "”"],
      ["-", "—"],
      ["`", "¸"]
    ],
    "row2": [
      ["j", "J"],
      ["d", "D"],
      ["u", "U"],
      ["a", "A"],
      ["x", "X"],
      ["p", "P"],
      ["h", "H"],
      ["l", "L"],
      ["m", "M"],
      ["w", "W"],
      ["ß", "ẞ"],
      ["'", "~"]
    ],
    "row3": [
      ["c", "C"],
      ["t", "T"],
      ["i", "I"],
      ["e", "E"],
      ["o", "O"],
      ["b", "B"],
      ["n", "N"],
      ["r", "R"],
      ["s", "S"],
      ["g", "G"],
      ["q", "Q"],
      [" "]
    ],
    "row4": [
      [" "],
      ["f", "F"],
      ["v", "V"],
      ["ü", "Ü"],
      ["ä", "Ä"],
      ["ö", "Ö"],
      ["y", "Y"],
      ["z", "Z"],
      [",", "–"],
      [".", "•"],
      ["k", "K"]
    ],
    "row5": [[" "]]
  }
}
