{
  "keymapShowTopRow": true,
  "type": "ansi",
  "keys": {
    "row1": [
      ["$", "~"],
      ["&", "%"],
      ["[", "7"],
      ["{", "5"],
      ["}", "3"],
      ["(", "1"],
      ["=", "9"],
      ["*", "0"],
      [")", "2"],
      ["+", "4"],
      ["]", "6"],
      ["!", "8"],
      ["#", "`"]
    ],
    "row2": [
      [",", "<"],
      [".", ">"],
      ["u", "U"],
      ["c", "C"],
      ["v", "V"],
      ["q", "Q"],
      ["f", "F"],
      ["d", "D"],
      ["l", "L"],
      ["y", "Y"],
      ["/", "?"],
      ["@", "^"],
      ["\\", "|"]
    ],
    "row3": [
      ["a", "A"],
      ["o", "O"],
      ["e", "E"],
      ["s", "S"],
      ["g", "G"],
      ["b", "B"],
      ["n", "N"],
      ["t", "T"],
      ["r", "R"],
      ["i", "I"],
      ["-", "_"]
    ],
    "row4": [
      ["x", "X"],
      ["'", "\""],
      ["w", "W"],
      [";", ":"],
      ["z", "Z"],
      ["p", "P"],
      ["h", "H"],
      ["m", "M"],
      ["k", "K"],
      ["j", "J"]
    ],
    "row5": [[" "]]
  }
}
