{
  "keymapShowTopRow": false,
  "type": "iso",
  "keys": {
    "row1": [
      ["=", "+"],
      ["1", "!"],
      ["2", "@"],
      ["3", "#"],
      ["4", "$"],
      ["5", "%"],
      ["6", "¨"],
      ["7", "&"],
      ["8", "*"],
      ["9", "("],
      ["0", ")"],
      ["[", "{"],
      ["]", "}"]
    ],
    "row2": [
      ["/", "?"],
      [",", "<"],
      [".", ">"],
      ["h", "H"],
      ["x", "X"],
      ["w", "W"],
      ["l", "L"],
      ["t", "T"],
      ["c", "C"],
      ["p", "P"],
      ["~", "^"],
      ["-", "_"]
    ],
    "row3": [
      ["i", "I"],
      ["e", "E"],
      ["a", "A"],
      ["o", "O"],
      ["u", "U"],
      ["m", "M"],
      ["d", "D"],
      ["s", "S"],
      ["r", "R"],
      ["n", "N"],
      ["´", "`"],
      ["'", "\""]
    ],
    "row4": [
      [";", ":"],
      ["y", "Y"],
      ["ç", "Ç"],
      ["j", "J"],
      ["b", "B"],
      ["k", "K"],
      ["q", "Q"],
      ["v", "V"],
      ["g", "G"],
      ["f", "F"],
      ["z", "Z"]
    ],
    "row5": [[" "]]
  }
}
