{
  "keymapShowTopRow": false,
  "type": "iso",
  "keys": {
    "row1": [
      ["ч", "Ч"],
      ["1", "!"],
      ["2", "@"],
      ["3", "№"],
      ["4", "$"],
      ["5", "%"],
      ["6", "€"],
      ["7", "§"],
      ["8", "*"],
      ["9", "("],
      ["0", ")"],
      ["-", "_"],
      ["=", "+"]
    ],
    "row2": [
      ["я", "Я"],
      ["в", "В"],
      ["е", "Е"],
      ["р", "Р"],
      ["т", "Т"],
      ["ъ", "Ъ"],
      ["у", "У"],
      ["и", "И"],
      ["о", "О"],
      ["п", "П"],
      ["ш", "Ш"],
      ["щ", "Щ"]
    ],
    "row3": [
      ["а", "А"],
      ["с", "С"],
      ["д", "Д"],
      ["ф", "Ф"],
      ["г", "Г"],
      ["х", "Х"],
      ["й", "Й"],
      ["к", "К"],
      ["л", "Л"],
      [";", ":"],
      ["'", "\""],
      ["ю", "Ю"]
    ],
    "row4": [
      ["ю", "Ю"],
      ["з", "З"],
      ["ь", "Ь"],
      ["ц", "Ц"],
      ["ж", "Ж"],
      ["б", "Б"],
      ["н", "Н"],
      ["м", "М"],
      [",", "<"],
      [".", ">"],
      ["/", "?"]
    ],
    "row5": [[" "]]
  }
}
