{
  "keymapShowTopRow": false,
  "type": "iso",
  "keys": {
    "row1": [
      ["(", ")"],
      ["1", "!"],
      ["2", "?"],
      ["3", "+"],
      ["4", "\""],
      ["5", "%"],
      ["6", "="],
      ["7", ":"],
      ["8", "/"],
      ["9", "–"],
      ["0", "№"],
      ["-", "$"],
      [".", "€"]
    ],
    "row2": [
      [",", "ы"],
      ["у", "У"],
      ["е", "Е"],
      ["и", "И"],
      ["ш", "Ш"],
      ["щ", "Щ"],
      ["к", "К"],
      ["с", "С"],
      ["д", "Д"],
      ["з", "З"],
      ["ц", "Ц"],
      [";", "§"]
    ],
    "row3": [
      ["ь", "ѝ"],
      ["я", "Я"],
      ["а", "А"],
      ["о", "О"],
      ["ж", "Ж"],
      ["г", "Г"],
      ["т", "Т"],
      ["н", "Н"],
      ["в", "В"],
      ["м", "М"],
      ["ч", "Ч"],
      ["„", "“"]
    ],
    "row4": [
      ["ѝ", "Ѝ"],
      ["ю", "Ю"],
      ["й", "Й"],
      ["ъ", "Ъ"],
      ["э", "Э"],
      ["ф", "Ф"],
      ["х", "Х"],
      ["п", "П"],
      ["р", "Р"],
      ["л", "Л"],
      ["б", "Б"]
    ],
    "row5": [[" "]]
  }
}
