{
  "keymapShowTopRow": true,
  "type": "ansi",
  "keys": {
    "row1": [
      ["ၐ", "ဎ"],
      ["၁", "ဍ"],
      ["၂", "ၒ"],
      ["၃", "ဋ"],
      ["၄", "ၓ"],
      ["၅", "ၔ"],
      ["၆", "ၕ"],
      ["၇", "ရ"],
      ["၈", "*"],
      ["၉", "("],
      ["၀", ")"],
      ["-", "_"],
      ["=", "+"]
    ],
    "row2": [
      ["ဆ", "ဈ"],
      ["တ", "ဝ"],
      ["န", "ဣ"],
      ["မ", "၎"],
      ["အ", "ဤ"],
      ["ပ", "၌"],
      ["က", "ဥ"],
      ["င", "၍"],
      ["သ", "ဿ"],
      ["စ", "ဏ"],
      ["ဟ", "ဧ"],
      ["ဩ", "ဪ"],
      ["\\", "|"]
    ],
    "row3": [
      ["ေ", "ဗ"],
      ["ျ", "ှ"],
      ["ိ", "ီ"],
      ["်", "္"],
      ["ါ", "ွ"],
      ["့", "ံ"],
      ["ြ", "ဲ"],
      ["ု", "ဒ"],
      ["ူ", "ဓ"],
      ["း", "ဂ"],
      ["'", "\""]
    ],
    "row4": [
      ["ဖ", "ဇ"],
      ["ထ", "ဌ"],
      ["ခ", "ဃ"],
      ["လ", "ဠ"],
      ["ဘ", "ယ"],
      ["ည", "ဉ"],
      ["ာ", "ဦ"],
      [",", "၊"],
      [".", "။"],
      ["/", "?"]
    ],
    "row5": [[" "]]
  }
}
