{
  "keymapShowTopRow": false,
  "type": "ansi",
  "keys": {
    "row1": [
      ["`", "~"],
      ["1", "!"],
      ["2", "@"],
      ["3", "#"],
      ["4", "$"],
      ["5", "%"],
      ["6", "^"],
      ["7", "&"],
      ["8", "*"],
      ["9", "("],
      ["0", ")"],
      ["-", "_"],
      ["=", "+"]
    ],
    "row2": [
      ["w", "W"],
      ["l", "L"],
      ["y", "Y"],
      ["p", "P"],
      ["b", "B"],
      ["z", "Z"],
      ["f", "F"],
      ["o", "O"],
      ["u", "U"],
      ["'", "\""],
      ["[", "{"],
      ["]", "}"],
      ["\\", "|"]
    ],
    "row3": [
      ["c", "C"],
      ["r", "R"],
      ["s", "S"],
      ["t", "T"],
      ["g", "G"],
      ["m", "M"],
      ["n", "N"],
      ["e", "E"],
      ["i", "I"],
      ["a", "A"],
      [";", ":"]
    ],
    "row4": [
      ["q", "Q"],
      ["j", "J"],
      ["v", "V"],
      ["d", "D"],
      ["k", "K"],
      ["x", "X"],
      ["h", "H"],
      ["/", "?"],
      [",", "<"],
      [".", ">"]
    ],
    "row5": [[" "]]
  }
}
