{
  "keymapShowTopRow": true,
  "type": "ansi",
  "keys": {
    "row1": [
      ["`", "~"],
      ["1", "!"],
      ["2", "@"],
      ["3", "#"],
      ["4", "$"],
      ["5", "%"],
      ["6", "^"],
      ["7", "&"],
      ["8", "*"],
      ["9", "("],
      ["0", ")"],
      ["[", "{"],
      ["]", "}"]
    ],
    "row2": [
      ["'", "\""],
      [",", "<"],
      [".", ">"],
      ["p", "P"],
      ["y", "Y"],
      ["q", "Q"],
      ["f", "F"],
      ["g", "G"],
      ["r", "R"],
      ["k", "K"],
      ["/", "?"],
      ["=", "+"],
      ["\\", "|"]
    ],
    "row3": [
      ["o", "O"],
      ["a", "A"],
      ["e", "E"],
      ["i", "I"],
      ["u", "U"],
      ["d", "D"],
      ["h", "H"],
      ["t", "T"],
      ["n", "N"],
      ["s", "S"],
      ["-", "_"]
    ],
    "row4": [
      ["z", "Z"],
      ["x", "X"],
      ["c", "C"],
      ["v", "V"],
      ["j", "J"],
      ["l", "L"],
      ["m", "M"],
      ["w", "W"],
      ["b", "B"],
      [";", ":"]
    ],
    "row5": [[" "]]
  }
}
