{
  "keymapShowTopRow": false,
  "type": "iso",
  "keys": {
    "row1": [
      ["`", "~"],
      ["1", "!"],
      ["2", "@"],
      ["3", "#"],
      ["4", "$"],
      ["5", "%"],
      ["6", "^"],
      ["=", "+"],
      ["7", "&"],
      ["8", "*"],
      ["9", "("],
      ["0", ")"],
      ["-", "_"]
    ],
    "row2": [
      ["q", "Q"],
      ["w", "W"],
      ["f", "F"],
      ["p", "P"],
      ["b", "B"],
      ["[", "{"],
      ["j", "J"],
      ["l", "L"],
      ["u", "U"],
      ["y", "Y"],
      [";", ":"],
      ["/", "?"]
    ],
    "row3": [
      ["a", "A"],
      ["r", "R"],
      ["s", "S"],
      ["t", "T"],
      ["g", "G"],
      ["]", "}"],
      ["m", "M"],
      ["n", "N"],
      ["e", "E"],
      ["i", "I"],
      ["o", "O"],
      ["'", "\""]
    ],
    "row4": [
      ["z", "Z"],
      ["x", "X"],
      ["c", "C"],
      ["d", "D"],
      ["v", "V"],
      ["\\", "|"],
      ["#", "#"],
      ["k", "K"],
      ["h", "H"],
      [",", "<"],
      [".", ">"]
    ],
    "row5": [[" "]]
  }
}
