{
  "keymapShowTopRow": false,
  "type": "ansi",
  "keys": {
    "row1": [
      ["`", "~"],
      ["1", "!"],
      ["2", "@"],
      ["3", "#"],
      ["4", "$"],
      ["5", "%"],
      ["6", "^"],
      ["7", "&"],
      ["8", "*"],
      ["9", "("],
      ["0", ")"],
      ["=", "+"],
      ["[", "{"]
    ],
    "row2": [
      ["q", "Q"],
      ["w", "W"],
      ["c", "C"],
      ["p", "P"],
      ["b", "B"],
      ["j", "J"],
      ["l", "L"],
      ["u", "U"],
      ["y", "Y"],
      [";", ":"],
      ["-", "_"],
      ["]", "}"],
      ["\\", "|"]
    ],
    "row3": [
      ["a", "A"],
      ["r", "R"],
      ["s", "S"],
      ["t", "T"],
      ["g", "G"],
      ["m", "M"],
      ["n", "N"],
      ["e", "E"],
      ["i", "I"],
      ["o", "O"],
      ["'", "\""]
    ],
    "row4": [
      ["z", "Z"],
      ["x", "X"],
      ["f", "F"],
      ["d", "D"],
      ["k", "K"],
      ["v", "V"],
      ["h", "H"],
      ["/", "?"],
      [".", ">"],
      [",", "<"]
    ],
    "row5": [[" "]]
  }
}
