{
  "keymapShowTopRow": true,
  "type": "ansi",
  "keys": {
    "row1": [
      ["`", "~"],
      ["1", "!"],
      ["2", "@"],
      ["3", "#"],
      ["4", "$"],
      ["5", "%"],
      ["6", "^"],
      ["7", "&"],
      ["8", "*"],
      ["9", "("],
      ["0", ")"],
      ["=", "+"],
      ["[", "{"]
    ],
    "row2": [
      [";", ":"],
      ["l", "L"],
      ["c", "C"],
      ["m", "M"],
      ["k", "K"],
      ["j", "J"],
      ["f", "F"],
      ["u", "U"],
      ["y", "Y"],
      ["q", "Q"],
      ["-", "_"],
      ["]", "}"],
      ["\\", "|"]
    ],
    "row3": [
      ["a", "A"],
      ["r", "R"],
      ["s", "S"],
      ["t", "T"],
      ["g", "G"],
      ["p", "P"],
      ["n", "N"],
      ["e", "E"],
      ["i", "I"],
      ["o", "O"],
      ["'", "\""]
    ],
    "row4": [
      ["x", "X"],
      ["w", "W"],
      ["d", "D"],
      ["v", "V"],
      ["z", "Z"],
      ["b", "B"],
      ["h", "H"],
      ["/", "?"],
      [".", ">"],
      [",", "<"]
    ],
    "row5": [[" "]]
  }
}
