{
  "keymapShowTopRow": false,
  "type": "ansi",
  "keys": {
    "row1": [
      ["`", "~"],
      ["1", "!"],
      ["2", "@"],
      ["3", "#"],
      ["4", "$"],
      ["5", "%"],
      ["6", "^"],
      ["7", "&"],
      ["8", "*"],
      ["9", "("],
      ["0", ")"],
      ["-", "_"],
      ["=", "+"]
    ],
    "row2": [
      ["q", "Q"],
      ["p", "P"],
      ["l", "L"],
      ["c", "C"],
      ["j", "J"],
      ["x", "X"],
      ["f", "F"],
      ["o", "O"],
      ["u", "U"],
      ["/", "?"],
      ["[", "{"],
      ["]", "}"],
      ["\\", "|"]
    ],
    "row3": [
      ["r", "R"],
      ["n", "N"],
      ["t", "T"],
      ["s", "S"],
      ["g", "G"],
      ["y", "Y"],
      ["h", "H"],
      ["e", "E"],
      ["i", "I"],
      ["a", "A"],
      [";", ":"]
    ],
    "row4": [
      ["z", "Z"],
      ["b", "B"],
      ["m", "M"],
      ["w", "W"],
      ["v", "V"],
      ["k", "K"],
      ["d", "D"],
      ["'", "\""],
      [",", "<"],
      [".", ">"]
    ],
    "row5": [[" "]]
  }
}
