{
  "keymapShowTopRow": false,
  "type": "ansi",
  "keys": {
    "row1": [
      ["`", "~"],
      ["1", "!"],
      ["2", "@"],
      ["3", "#"],
      ["4", "$"],
      ["5", "%"],
      ["6", "^"],
      ["7", "&"],
      ["8", "*"],
      ["9", ")"],
      ["0", "("],
      ["-", "_"],
      ["=", "+"]
    ],
    "row2": [
      ["ޮ", "ޯ"],
      ["އ", "ޢ"],
      ["ެ", "ޭ"],
      ["ރ", "ޜ"],
      ["ތ", "ޓ"],
      ["ޔ", "ޠ"],
      ["ު", "ޫ"],
      ["ި", "ީ"],
      ["ޮ", "ޯ"],
      ["ޕ", "÷"],
      ["[", "{"],
      ["]", "}"],
      ["\\", "|"]
    ],
    "row3": [
      ["ަ", "ާ"],
      ["ސ", "ށ"],
      ["ދ", "ޑ"],
      ["ފ", "ﷲ"],
      ["ގ", "ޣ"],
      ["ހ", "ޙ"],
      ["ޖ", "ޛ"],
      ["ކ", "ޚ"],
      ["ލ", "ޅ"],
      ["؛", ":"],
      ["'", "\""]
    ],
    "row4": [
      ["ޒ", "ޡ"],
      ["×", "ޘ"],
      ["ޗ", "ޝ"],
      ["ވ", "ޥ"],
      ["ބ", "ޞ"],
      ["ނ", "ޏ"],
      ["މ", "ޟ"],
      ["،", "ޤ"],
      [".", ">"],
      ["/", "؟"]
    ],
    "row5": [[" "]]
  }
}
