{
  "keymapShowTopRow": false,
  "type": "ansi",
  "keys": {
    "row1": [
      ["`", "~"],
      ["1", "!"],
      ["2", "@"],
      ["3", "#"],
      ["4", "$"],
      ["5", "%"],
      ["6", "^"],
      ["7", "&"],
      ["8", "*"],
      ["9", "("],
      ["0", ")"],
      ["-", "_"],
      ["=", "+"]
    ],
    "row2": [
      ["v", "V"],
      ["l", "L"],
      ["h", "H"],
      ["k", "K"],
      ["q", "Q"],
      ["j", "J"],
      ["f", "F"],
      ["o", "O"],
      ["u", "U"],
      [",", "<"],
      ["[", "{"],
      ["]", "}"],
      ["\\", "|"]
    ],
    "row3": [
      ["s", "S"],
      ["r", "R"],
      ["n", "N"],
      ["t", "T"],
      ["w", "W"],
      ["y", "Y"],
      ["c", "C"],
      ["a", "A"],
      ["e", "E"],
      ["i", "I"],
      ["/", "?"]
    ],
    "row4": [
      ["z", "Z"],
      ["x", "X"],
      ["m", "M"],
      ["d", "D"],
      ["b", "B"],
      ["p", "P"],
      ["g", "G"],
      ["'", "\""],
      [";", ":"],
      [".", ">"]
    ],
    "row5": [[" "]]
  }
}
