{
  "keymapShowTopRow": true,
  "type": "ansi",
  "keys": {
    "row1": [
      ["ё", "Ё"],
      ["1", "Ъ"],
      ["2", "Ь"],
      ["3", "№"],
      ["4", "%"],
      ["5", ":"],
      ["6", ";"],
      ["7", "-"],
      ["8", "\""],
      ["9", "("],
      ["0", ")"],
      ["*", "_"],
      ["=", "+"]
    ],
    "row2": [
      ["ц", "Ц"],
      ["ь", "ъ"],
      ["я", "Я"],
      [",", "?"],
      [".", "!"],
      ["з", "З"],
      ["в", "В"],
      ["к", "К"],
      ["д", "Д"],
      ["ч", "Ч"],
      ["ш", "Ш"],
      ["щ", "Щ"],
      ["\\", "/"]
    ],
    "row3": [
      ["у", "У"],
      ["и", "И"],
      ["е", "Е"],
      ["о", "О"],
      ["а", "А"],
      ["л", "Л"],
      ["н", "Н"],
      ["т", "Т"],
      ["с", "С"],
      ["р", "Р"],
      ["й", "Й"]
    ],
    "row4": [
      ["ф", "Ф"],
      ["э", "Э"],
      ["х", "Х"],
      ["ы", "Ы"],
      ["ю", "Ю"],
      ["б", "Б"],
      ["м", "М"],
      ["п", "П"],
      ["г", "Г"],
      ["ж", "Ж"]
    ],
    "row5": [[" "]]
  }
}
