{
  "keymapShowTopRow": false,
  "type": "ansi",
  "keys": {
    "row1": [
      ["`", "~"],
      ["1", "!"],
      ["2", "@"],
      ["3", "#"],
      ["4", "$"],
      ["5", "%"],
      ["6", "^"],
      ["7", "&"],
      ["8", "*"],
      ["9", "("],
      ["0", ")"],
      ["-", "_"],
      ["=", "+"]
    ],
    "row2": [
      ["x", "X"],
      ["f", "F"],
      ["d", "D"],
      ["p", "P"],
      ["q", "Q"],
      ["j", "J"],
      ["'", "\""],
      ["o", "O"],
      ["u", "U"],
      [".", ">"],
      ["[", "{"],
      ["]", "}"],
      ["\\", "|"]
    ],
    "row3": [
      ["n", "N"],
      ["s", "S"],
      ["t", "T"],
      ["c", "C"],
      ["y", "Y"],
      ["m", "M"],
      ["h", "H"],
      ["a", "A"],
      ["e", "E"],
      ["i", "I"],
      [";", ":"]
    ],
    "row4": [
      ["b", "B"],
      ["v", "V"],
      ["k", "K"],
      ["g", "G"],
      ["w", "W"],
      ["z", "Z"],
      ["l", "L"],
      ["-", "_"],
      ["/", "?"],
      [",", "<"]
    ],
    "row5": [["r", "R"], [" "]]
  }
}
