{
  "keymapShowTopRow": true,
  "type": "ansi",
  "keys": {
    "row1": [
      ["`", "~"],
      ["[", "{"],
      ["]", "}"],
      ["/", "?"],
      ["p", "P"],
      ["f", "F"],
      ["m", "M"],
      ["l", "L"],
      ["j", "J"],
      ["4", "$"],
      ["3", "#"],
      ["2", "@"],
      ["1", "!"]
    ],
    "row2": [
      [";", ":"],
      ["q", "Q"],
      ["b", "B"],
      ["y", "Y"],
      ["u", "U"],
      ["r", "R"],
      ["s", "S"],
      ["o", "O"],
      [".", ">"],
      ["6", "^"],
      ["5", "%"],
      ["=", "+"],
      ["\\", "|"]
    ],
    "row3": [
      ["-", "_"],
      ["k", "K"],
      ["c", "C"],
      ["d", "D"],
      ["t", "T"],
      ["h", "H"],
      ["e", "E"],
      ["a", "A"],
      ["z", "Z"],
      ["8", "*"],
      ["7", "&"]
    ],
    "row4": [
      ["'", "\""],
      ["x", "X"],
      ["g", "G"],
      ["v", "V"],
      ["w", "W"],
      ["n", "N"],
      ["i", "I"],
      [",", "<"],
      ["0", ")"],
      ["9", "("]
    ],
    "row5": [[" "]]
  }
}
