{
  "keymapShowTopRow": false,
  "type": "iso",
  "keys": {
    "row1": [
      ["*", "«"],
      ["1", "»"],
      ["2", "/"],
      ["3", "-"],
      ["4", "è"],
      ["5", "\\"],
      ["6", "^"],
      ["7", "("],
      ["8", "`"],
      ["9", ")"],
      ["0", "_"],
      ["+", "["],
      ["%", "]"]
    ],
    "row2": [
      ["?", ":"],
      ["<", "'"],
      [">", "é"],
      ["g", "G"],
      ["!", "."],
      ["h", "H"],
      ["v", "V"],
      ["c", "C"],
      ["m", "M"],
      ["k", "K"],
      ["z", "Z"],
      ["=", "-"]
    ],
    "row3": [
      ["o", "O"],
      ["a", "A"],
      ["u", "U"],
      ["e", "E"],
      ["b", "B"],
      ["f", "F"],
      ["s", "S"],
      ["t", "T"],
      ["n", "N"],
      ["d", "D"],
      ["w", "W"],
      ["#", "~"]
    ],
    "row4": [
      ["ç", "à"],
      ["|", ";"],
      ["q", "Q"],
      ["@", ","],
      ["i", "I"],
      ["y", "Y"],
      ["x", "X"],
      ["r", "R"],
      ["l", "L"],
      ["p", "P"],
      ["j", "J"]
    ],
    "row5": [[" "]]
  }
}
