{
  "keymapShowTopRow": false,
  "type": "ansi",
  "keys": {
    "row1": [
      ["`", "~"],
      ["1", "!"],
      ["2", "@"],
      ["3", "#"],
      ["4", "$"],
      ["5", "%"],
      ["6", "^"],
      ["7", "&"],
      ["8", "*"],
      ["9", "("],
      ["0", ")"],
      ["-", "_"],
      ["=", "+"]
    ],
    "row2": [
      ["v", "V"],
      ["l", "L"],
      ["h", "H"],
      ["k", "K"],
      ["j", "J"],
      ["g", "G"],
      ["w", "W"],
      ["o", "O"],
      ["u", "U"],
      [",", ">"],
      ["[", "{"],
      ["]", "}"],
      ["\\", "|"]
    ],
    "row3": [
      ["s", "S"],
      ["r", "R"],
      ["n", "N"],
      ["t", "T"],
      ["m", "M"],
      ["y", "Y"],
      ["d", "D"],
      ["a", "A"],
      ["e", "E"],
      ["i", "I"],
      ["/", "?"]
    ],
    "row4": [
      ["x", "X"],
      ["q", "Q"],
      ["b", "B"],
      ["f", "F"],
      ["z", "Z"],
      ["p", "P"],
      ["c", "C"],
      ["'", "\""],
      [";", ":"],
      [".", "<"]
    ],
    "row5": [[" "]]
  }
}
