{
  "keymapShowTopRow": false,
  "type": "iso",
  "keys": {
    "row1": [
      ["`", "~"],
      ["1", "!"],
      ["2", "@"],
      ["3", "#"],
      ["4", "$"],
      ["5", "%"],
      ["6", "^"],
      ["7", "&"],
      ["8", "*"],
      ["9", "("],
      ["0", ")"],
      ["-", "_"],
      ["=", "+"]
    ],
    "row2": [
      ["ŝ", "Ŝ"],
      ["ĝ", "Ĝ"],
      ["e", "E"],
      ["r", "R"],
      ["t", "T"],
      ["ŭ", "Ŭ"],
      ["u", "U"],
      ["i", "I"],
      ["o", "O"],
      ["p", "P"],
      ["ĵ", "Ĵ"],
      ["ĥ", "Ĥ"]
    ],
    "row3": [
      ["a", "A"],
      ["s", "S"],
      ["d", "D"],
      ["f", "F"],
      ["g", "G"],
      ["h", "H"],
      ["j", "J"],
      ["k", "K"],
      ["l", "L"],
      [";", ":"],
      ["'", "\""],
      ["\\", "|"]
    ],
    "row4": [
      ["<", ">"],
      ["z", "Z"],
      ["ĉ", "Ĉ"],
      ["c", "C"],
      ["v", "V"],
      ["b", "B"],
      ["n", "N"],
      ["m", "M"],
      [",", "<"],
      [".", ">"],
      ["/", "?"]
    ],
    "row5": [[" "]]
  }
}
