{
  "keymapShowTopRow": true,
  "type": "ansi",
  "keys": {
    "row1": [
      ["`", "~"],
      ["1", "!"],
      ["2", "@"],
      ["3", "#"],
      ["4", "$"],
      ["5", "%"],
      ["6", "^"],
      ["7", "&"],
      ["8", "*"],
      ["9", "("],
      ["0", ")"],
      ["[", "{"],
      ["]", "}"]
    ],
    "row2": [
      ["b", "B"],
      ["y", "Y"],
      ["o", "O"],
      ["u", "U"],
      ["'", "\""],
      [";", ":"],
      ["l", "L"],
      ["d", "D"],
      ["w", "W"],
      ["v", "V"],
      ["z", "Z"],
      ["=", "+"],
      ["\\", "|"]
    ],
    "row3": [
      ["c", "C"],
      ["i", "I"],
      ["e", "E"],
      ["a", "A"],
      [",", "<"],
      [".", ">"],
      ["h", "H"],
      ["t", "T"],
      ["s", "S"],
      ["n", "N"],
      ["q", "Q"]
    ],
    "row4": [
      ["g", "G"],
      ["x", "X"],
      ["j", "J"],
      ["k", "K"],
      ["-", "_"],
      ["/", "?"],
      ["r", "R"],
      ["m", "M"],
      ["f", "F"],
      ["p", "P"]
    ],
    "row5": [[" "]]
  }
}
