{
  "keymapShowTopRow": false,
  "type": "iso",
  "keys": {
    "row1": [
      ["=", "+", "}"],
      ["1", "1", "1", "1"],
      ["2", "2", "2", "2"],
      ["3", "3", "3", "3"],
      ["4", "4", "4", "4"],
      ["5", "5", "5", "5"],
      ["6", "6", "6", "6"],
      ["7", "7", "7", "7"],
      ["8", "8", "8", "8"],
      ["9", "9", "9", "9"],
      ["0", "º", "°", "ª"],
      ["€", "€", "£", "¤"],
      ["%", "%", "‰", "‱"]
    ],
    "row2": [
      ["è", "È", "`", "„"],
      ["y", "Y", "@"],
      ["o", "O", "œ", "Œ"],
      ["w", "W", "ù", "Ù"],
      ["b", "B", "«", "“"],
      ["f", "F", "»", "”"],
      ["g", "G", "~", "≈"],
      ["h", "H", "#", "%"],
      ["c", "C"],
      ["x", "X", "*", "×"],
      ["z", "Z"],
      ["ç", "Ç"]
    ],
    "row3": [
      ["a", "A", "<", "⩽"],
      ["i", "I", ">", "⩾"],
      ["e", "E", "{", "ᵉ"],
      ["u", "U", "}"],
      [".", ":", ":", "·"],
      ["v", "V", "|", "¦"],
      ["s", "S", "(", "—"],
      ["n", "N", ")", "–"],
      ["t", "T", "["],
      ["r", "R", "["],
      ["q", "Q", "’"],
      ["^", "!", "!", "¡"]
    ],
    "row4": [
      ["ê", "Ê"],
      ["é", "É", "/", "÷"],
      ["à", "À", "\\", "ᵢ"],
      ["j", "J", "\""],
      [",", ";", ";"],
      ["k", "K", "…"],
      ["m", "M", "&", "−"],
      ["d", "D", "$", "§"],
      ["l", "L", "=", "≠"],
      ["p", "P", "+", "±"],
      ["'", "?", "?", "¿"]
    ],
    "row5": [[" ", "-"]]
  }
}
