{
  "keymapShowTopRow": false,
  "type": "ansi",
  "keys": {
    "row1": [
      ["`", "~"],
      ["1", "€"],
      ["2", "«"],
      ["3", "»"],
      ["4", "$"],
      ["5", "%"],
      ["6", "^"],
      ["7", "&"],
      ["8", "*"],
      ["9", "#"],
      ["0", "@"],
      ["/", "_"],
      ["=", "+"]
    ],
    "row2": [
      ["q", "Q"],
      ["c", "C"],
      ["o", "O"],
      ["p", "P"],
      ["w", "W"],
      ["j", "J"],
      ["m", "M"],
      ["d", "D"],
      ["’", "!"],
      ["y", "Y"],
      ["[", "{"],
      ["]", "}"],
      ["\\", "|"]
    ],
    "row3": [
      ["a", "A"],
      ["s", "S"],
      ["e", "E"],
      ["n", "N"],
      ["f", "F"],
      ["l", "L"],
      ["r", "R"],
      ["t", "T"],
      ["i", "I"],
      ["u", "U"],
      ["'", "\""]
    ],
    "row4": [
      ["z", "Z"],
      ["x", "X"],
      ["-", "?"],
      ["v", "V"],
      ["b", "B"],
      [".", ":"],
      ["h", "H"],
      ["g", "G"],
      [",", ";"],
      ["k", "K"]
    ],
    "row5": [[" "]]
  }
}
