{
  "keymapShowTopRow": false,
  "type": "ansi",
  "keys": {
    "row1": [
      ["`", "~"],
      ["1", "€"],
      ["2", "«"],
      ["3", "»"],
      ["4", "$"],
      ["5", "%"],
      ["6", "^"],
      ["7", "&"],
      ["8", "*"],
      ["9", "#"],
      ["0", "@"],
      ["/", "_"],
      ["=", "+"]
    ],
    "row2": [
      ["q", "Q"],
      ["w", "W"],
      ["o", "O"],
      ["p", "P"],
      ["`", "˜"],
      ["?", "!"],
      ["m", "M"],
      ["d", "D"],
      ["j", "J"],
      ["k", "K"],
      ["[", "{"],
      ["]", "}"],
      ["\\", "|"]
    ],
    "row3": [
      ["a", "A"],
      ["s", "S"],
      ["e", "E"],
      ["n", "N"],
      ["f", "F"],
      ["l", "L"],
      ["r", "R"],
      ["t", "T"],
      ["i", "I"],
      ["u", "U"],
      ["'", "\""]
    ],
    "row4": [
      ["z", "Z"],
      ["x", "X"],
      ["c", "C"],
      ["v", "V"],
      [",", ";"],
      [".", ":"],
      ["h", "H"],
      ["b", "B"],
      ["g", "G"],
      ["y", "Y"]
    ],
    "row5": [[" "]]
  }
}
