{
  "keymapShowTopRow": false,
  "type": "ansi",
  "keys": {
    "row1": [
      ["`", "~"],
      ["1", "!"],
      ["2", "@"],
      ["3", "#"],
      ["4", "$"],
      ["5", "%"],
      ["6", "^"],
      ["7", "&"],
      ["8", "*"],
      ["9", "("],
      ["0", ")"],
      ["-", "_"],
      ["=", "+"]
    ],
    "row2": [
      ["f", "F"],
      ["l", "L"],
      ["a", "A"],
      ["w", "W"],
      ["p", "P"],
      ["z", "Z"],
      ["k", "K"],
      ["u", "U"],
      ["r", "R"],
      ["/", "?"],
      ["[", "{"],
      ["]", "}"],
      ["\\", "|"]
    ],
    "row3": [
      ["h", "H"],
      ["s", "S"],
      ["o", "O"],
      ["y", "Y"],
      ["c", "C"],
      ["m", "M"],
      ["t", "T"],
      ["e", "E"],
      ["n", "N"],
      ["i", "I"],
      [";", ":"]
    ],
    "row4": [
      ["b", "B"],
      ["j", "J"],
      ["'", "\""],
      ["g", "G"],
      ["v", "V"],
      ["q", "Q"],
      ["d", "D"],
      [".", ">"],
      ["x", "X"],
      [",", "<"]
    ],
    "row5": [[" "]]
  }
}
