{
  "keymapShowTopRow": false,
  "type": "ansi",
  "keys": {
    "row1": [
      ["`", "~"],
      ["1", "!"],
      ["2", "@"],
      ["3", "#"],
      ["4", "$"],
      ["5", "%"],
      ["6", "^"],
      ["7", "&"],
      ["8", "*"],
      ["9", "("],
      ["0", ")"],
      ["-", "_"],
      ["=", "+"]
    ],
    "row2": [
      ["b", "B"],
      ["l", "L"],
      ["d", "D"],
      ["c", "C"],
      ["v", "V"],
      ["j", "J"],
      ["f", "F"],
      ["o", "O"],
      ["u", "U"],
      [",", "<"],
      ["[", "{"],
      ["]", "}"],
      ["\\", "|"]
    ],
    "row3": [
      ["n", "N"],
      ["r", "R"],
      ["t", "T"],
      ["s", "S"],
      ["g", "G"],
      ["y", "Y"],
      ["h", "H"],
      ["a", "A"],
      ["e", "E"],
      ["i", "I"],
      ["/", "?"]
    ],
    "row4": [
      ["x", "X"],
      ["q", "Q"],
      ["m", "M"],
      ["w", "W"],
      ["z", "Z"],
      ["k", "K"],
      ["p", "P"],
      ["'", "\""],
      [";", ":"],
      [".", ">"]
    ],
    "row5": [[" "]]
  }
}
