{
  "keymapShowTopRow": false,
  "type": "ansi",
  "keys": {
    "row1": [
      ["`", "~"],
      ["1", "!"],
      ["2", "@"],
      ["3", "#"],
      ["4", "$"],
      ["5", "%"],
      ["6", "^"],
      ["7", "&"],
      ["8", "*"],
      ["9", "("],
      ["0", ")"],
      ["-", "_"],
      ["=", "+"]
    ],
    "row2": [
      ["b", "B"],
      ["l", "L"],
      ["d", "D"],
      ["c", "C"],
      ["j", "J"],
      ["z", "Z"],
      ["y", "Y"],
      ["o", "O"],
      ["u", "U"],
      [",", "<"],
      ["[", "{"],
      ["]", "}"],
      ["\\", "|"]
    ],
    "row3": [
      ["n", "N"],
      ["r", "R"],
      ["t", "T"],
      ["s", "S"],
      ["v", "V"],
      ["p", "P"],
      ["h", "H"],
      ["a", "A"],
      ["e", "E"],
      ["i", "I"],
      ["/", "?"]
    ],
    "row4": [
      ["x", "X"],
      ["m", "M"],
      ["w", "W"],
      ["g", "G"],
      ["q", "Q"],
      ["k", "K"],
      ["f", "F"],
      ["'", "\""],
      [";", ":"],
      [".", ">"]
    ],
    "row5": [[" "]]
  }
}
