{
  "keymapShowTopRow": false,
  "type": "iso",
  "keys": {
    "row1": [
      ["`", "¬"],
      ["1", "!"],
      ["2", "\""],
      ["3", "£"],
      ["4", "$"],
      ["5", "%"],
      ["6", "^"],
      ["7", "&"],
      ["8", "*"],
      ["9", "("],
      ["0", ")"],
      ["-", "_"],
      ["=", "+"]
    ],
    "row2": [
      ["b", "B"],
      ["l", "L"],
      ["d", "D"],
      ["c", "C"],
      ["z", "Z"],
      ["j", "J"],
      ["f", "F"],
      ["o", "O"],
      ["u", "U"],
      [",", "<"],
      ["[", "{"],
      ["]", "}"]
    ],
    "row3": [
      ["n", "N"],
      ["r", "R"],
      ["t", "T"],
      ["s", "S"],
      ["g", "G"],
      ["p", "P"],
      ["h", "H"],
      ["a", "A"],
      ["e", "E"],
      ["i", "I"],
      ["/", "?"],
      ["#", "~"]
    ],
    "row4": [
      ["q", "Q"],
      ["x", "X"],
      ["m", "M"],
      ["w", "W"],
      ["v", "V"],
      ["\\", "|"],
      ["k", "K"],
      ["y", "Y"],
      ["'", "@"],
      [";", ":"],
      [".", ">"]
    ],
    "row5": [[" "]]
  }
}
