{
  "keymapShowTopRow": false,
  "type": "ansi",
  "keys": {
    "row1": [
      ["`", "~"],
      ["1", "!"],
      ["2", "@"],
      ["3", "#"],
      ["4", "$"],
      ["5", "%"],
      ["6", "^"],
      ["7", "&"],
      ["8", "*"],
      ["9", "("],
      ["0", ")"],
      ["-", "_"],
      ["=", "+"]
    ],
    "row2": [
      ["b", "B"],
      ["l", "L"],
      ["d", "D"],
      ["c", "C"],
      ["v", "V"],
      ["y", "Y"],
      ["p", "P"],
      ["u", "U"],
      ["o", "O"],
      [",", "<"],
      ["[", "{"],
      ["]", "}"],
      ["\\", "|"]
    ],
    "row3": [
      ["n", "N"],
      ["r", "R"],
      ["t", "T"],
      ["s", "S"],
      ["w", "W"],
      ["f", "F"],
      ["h", "H"],
      ["e", "E"],
      ["a", "A"],
      ["i", "I"],
      ["/", "?"]
    ],
    "row4": [
      ["x", "X"],
      ["q", "Q"],
      ["m", "M"],
      ["g", "G"],
      ["j", "J"],
      ["z", "Z"],
      ["k", "K"],
      ["'", "\""],
      [";", ":"],
      [".", ">"]
    ],
    "row5": [[" "]]
  }
}
