{
  "keymapShowTopRow": true,
  "type": "iso",
  "keys": {
    "row1": [
      ["^", "°"],
      ["1", "!"],
      ["2", "\""],
      ["3", "§"],
      ["4", "$"],
      ["5", "%"],
      ["6", "&"],
      ["7", "/"],
      ["8", "("],
      ["9", ")"],
      ["0", "="],
      ["+", "*"],
      ["<", ">"]
    ],
    "row2": [
      ["ü", "Ü"],
      [",", ";"],
      [".", ":"],
      ["p", "P"],
      ["y", "Y"],
      ["f", "F"],
      ["g", "G"],
      ["c", "C"],
      ["t", "T"],
      ["z", "Z"],
      ["ß", "?"],
      ["\\", "/"]
    ],
    "row3": [
      ["a", "A"],
      ["o", "O"],
      ["e", "E"],
      ["i", "I"],
      ["u", "U"],
      ["h", "H"],
      ["d", "D"],
      ["r", "R"],
      ["n", "N"],
      ["s", "S"],
      ["l", "L"],
      ["-", "_"]
    ],
    "row4": [
      ["ä", "Ä"],
      ["ö", "Ö"],
      ["q", "Q"],
      ["j", "J"],
      ["k", "K"],
      ["x", "X"],
      ["b", "B"],
      ["m", "M"],
      ["w", "W"],
      ["v", "V"],
      ["#", "'"]
    ],
    "row5": [[" "]]
  }
}
