{
  "keymapShowTopRow": true,
  "type": "iso",
  "keys": {
    "row1": [
      ["^", "°"],
      ["1", "§"],
      ["2", "²"],
      ["3", "³"],
      ["4", "#"],
      ["5", "@"],
      ["6", "&"],
      ["7", "~"],
      ["8", "\\"],
      ["9", "("],
      ["0", ")"],
      ["+", "*"],
      ["=", "%"]
    ],
    "row2": [
      ["ü", "Ü"],
      [",", ";"],
      [".", ":"],
      ["p", "P"],
      ["y", "Y"],
      ["f", "F"],
      ["g", "G"],
      ["c", "C"],
      ["r", "R"],
      ["l", "L"],
      ["/", "?"],
      ["'", "\""]
    ],
    "row3": [
      ["a", "A"],
      ["o", "O"],
      ["e", "E"],
      ["u", "U"],
      ["i", "I"],
      ["d", "D"],
      ["h", "H"],
      ["t", "T"],
      ["n", "N"],
      ["s", "S"],
      ["ß", "!"],
      ["-", "_"]
    ],
    "row4": [
      ["ä", "Ä"],
      ["ö", "Ö"],
      ["q", "Q"],
      ["j", "J"],
      ["k", "K"],
      ["x", "X"],
      ["b", "B"],
      ["m", "M"],
      ["w", "W"],
      ["v", "V"],
      ["z", "Z"]
    ],
    "row5": [[" "]]
  }
}
