{
  "keymapShowTopRow": false,
  "type": "ansi",
  "keys": {
    "row1": [
      ["`", "~"],
      ["1", "!"],
      ["2", "@"],
      ["3", "#"],
      ["4", "$"],
      ["5", "%"],
      ["6", "^"],
      ["7", "&"],
      ["8", "*"],
      ["9", "("],
      ["0", ")"],
      ["-", "_"],
      ["=", "+"]
    ],
    "row2": [
      ["b", "B"],
      ["l", "L"],
      ["d", "D"],
      ["w", "W"],
      ["q", "Q"],
      ["j", "J"],
      ["f", "F"],
      ["o", "O"],
      ["u", "U"],
      ["'", "\""],
      ["[", "{"],
      ["]", "}"],
      ["\\", "|"]
    ],
    "row3": [
      ["n", "N"],
      ["r", "R"],
      ["t", "T"],
      ["s", "S"],
      ["g", "G"],
      ["y", "Y"],
      ["h", "H"],
      ["a", "A"],
      ["e", "E"],
      ["i", "I"],
      [";", ":"]
    ],
    "row4": [
      ["z", "Z"],
      ["x", "X"],
      ["m", "M"],
      ["c", "C"],
      ["v", "V"],
      ["k", "K"],
      ["p", "P"],
      [",", "<"],
      [".", ">"],
      ["/", "?"]
    ],
    "row5": [[" "]]
  }
}
