{
  "keymapShowTopRow": false,
  "type": "ansi",
  "keys": {
    "row1": [
      ["`", "~", "~", "≈"],
      ["1", "!", "̣", "¡"],
      ["2", "@", "̉", "²"],
      ["3", "#", "̛", "³"],
      ["4", "$", "¤", "£"],
      ["5", "%", "µ", "‰"],
      ["6", "^", "^", "∂"],
      ["7", "&", "ˇ", "¬"],
      ["8", "*", "˛", "∞"],
      ["9", "(", "˘", "·"],
      ["0", ")", "°", "°"],
      ["[", "{", "å", "Å"],
      ["]", "}", "æ", "Æ"]
    ],
    "row2": [
      ["b", "B", "•", "↑"],
      ["l", "L", "ł", "Ł"],
      ["d", "D", "ð", "Ð"],
      ["w", "W", "‘", "“"],
      ["q", "Q", "‚", "„"],
      ["j", "J", "ʃ", "Ʃ"],
      ["f", "F", "’", "”"],
      ["o", "O", "‹", "«"],
      ["u", "U", "›", "»"],
      ["'", "\"", "´", "′"],
      ["-", "_", "¯", "±"],
      ["=", "+", "˝", "≠"],
      ["\\", "|", "`", "¦"]
    ],
    "row3": [
      ["n", "N", "–", "↑"],
      ["r", "R", "®", "™"],
      ["t", "T", "þ", "Þ"],
      ["s", "S", "ß", "§"],
      ["g", "G", "ŋ", "Ŋ"],
      ["y", "Y", "º", "ª"],
      ["h", "H", "ħ", "Ħ"],
      ["a", "A", "đ", "α"],
      ["e", "E", "€", "←"],
      ["i", "I", "—", "→"],
      [";", ":", "¨", "…"]
    ],
    "row4": [
      ["z", "Z", "ʒ", "Ʒ"],
      ["x", "X", "†", "‡"],
      ["m", "M", "×", "↓"],
      ["c", "C", "©", "¢"],
      ["v", "V", "÷", "γ"],
      ["k", "K", "ç", "Ç"],
      ["p", "P", "π", "¶"],
      [".", ">", "˙", "≥"],
      ["/", "?", "/", "¿"],
      [",", "<", "¸", "≤"]
    ],
    "row5": [[" "]]
  }
}
