{
  "keymapShowTopRow": false,
  "type": "ansi",
  "keys": {
    "row1": [
      ["`", "~"],
      ["1", "!"],
      ["2", "@"],
      ["3", "#"],
      ["4", "$"],
      ["5", "%"],
      ["6", "^"],
      ["7", "&"],
      ["8", "*"],
      ["9", "("],
      ["0", ")"],
      ["[", "{"],
      ["]", "}"]
    ],
    "row2": [
      ["b", "B"],
      ["l", "L"],
      ["d", "D"],
      ["w", "W"],
      ["z", "Z"],
      ["'", "_"],
      ["f", "F"],
      ["o", "O"],
      ["u", "U"],
      ["j", "J"],
      [";", ":"],
      ["=", "+"],
      ["\\", "|"]
    ],
    "row3": [
      ["n", "N"],
      ["r", "R"],
      ["t", "T"],
      ["s", "S"],
      ["g", "G"],
      ["y", "Y"],
      ["h", "H"],
      ["a", "A"],
      ["e", "E"],
      ["i", "I"],
      [",", "?"]
    ],
    "row4": [
      ["x", "X"],
      ["m", "M"],
      ["c", "C"],
      ["v", "V"],
      ["q", "Q"],
      ["p", "P"],
      ["k", "K"],
      [".", ">"],
      ["-", "\""],
      ["/", "<"]
    ],
    "row5": [[" "]]
  }
}
