{
  "keymapShowTopRow": false,
  "type": "ansi",
  "keys": {
    "row1": [
      ["`", "~"],
      ["1", "!"],
      ["2", "@"],
      ["3", "#"],
      ["4", "$"],
      ["5", "%"],
      ["6", "^"],
      ["7", "&"],
      ["8", "*"],
      ["9", "("],
      ["0", ")"],
      ["[", "{"],
      ["]", "}"]
    ],
    "row2": [
      [";", ":"],
      ["u", "U"],
      ["o", "O"],
      ["f", "F"],
      ["j", "J"],
      ["q", "Q"],
      ["k", "K"],
      ["l", "L"],
      ["r", "R"],
      ["v", "V"],
      ["/", "?"],
      ["=", "+"],
      ["\\", "|"]
    ],
    "row3": [
      ["e", "E"],
      ["i", "I"],
      ["a", "A"],
      ["c", "C"],
      ["y", "Y"],
      ["d", "D"],
      ["h", "H"],
      ["t", "T"],
      ["n", "N"],
      ["s", "S"],
      ["-", "_"]
    ],
    "row4": [
      [",", "<"],
      [".", ">"],
      ["p", "P"],
      ["g", "G"],
      ["'", "\""],
      ["b", "B"],
      ["m", "M"],
      ["w", "W"],
      ["x", "X"],
      ["z", "Z"]
    ],
    "row5": [[" "]]
  }
}
