{
  "keymapShowTopRow": false,
  "type": "ansi",
  "keys": {
    "row1": [
      ["`", "~"],
      ["1", "!"],
      ["2", "@"],
      ["3", "#"],
      ["4", "$"],
      ["5", "%"],
      ["6", "^"],
      ["7", "&"],
      ["8", "*"],
      ["9", "<"],
      ["0", ">"],
      ["-", "_"],
      ["=", "+"]
    ],
    "row2": [
      ["w", "W"],
      ["l", "L"],
      ["r", "R"],
      ["b", "B"],
      ["z", "Z"],
      [";", ":"],
      ["q", "Q"],
      ["u", "U"],
      ["d", "D"],
      ["j", "J"],
      ["[", "{"],
      ["]", "}"],
      ["\\", "|"]
    ],
    "row3": [
      ["s", "S"],
      ["h", "H"],
      ["n", "N"],
      ["t", "T"],
      [",", "("],
      [".", ")"],
      ["a", "A"],
      ["e", "E"],
      ["o", "O"],
      ["i", "I"],
      ["'", "\""]
    ],
    "row4": [
      ["f", "F"],
      ["m", "M"],
      ["v", "V"],
      ["c", "C"],
      ["/", "?"],
      ["g", "G"],
      ["p", "P"],
      ["x", "X"],
      ["k", "K"],
      ["y", "Y"]
    ],
    "row5": [[" "]]
  }
}
