{
  "keymapShowTopRow": false,
  "type": "ansi",
  "keys": {
    "row1": [
      ["`", "~"],
      ["1", "!"],
      ["2", "@"],
      ["3", "#"],
      ["4", "$"],
      ["5", "%"],
      ["6", "^"],
      ["7", "&"],
      ["8", "*"],
      ["9", "("],
      ["0", ")"],
      ["-", "_"],
      ["=", "+"]
    ],
    "row2": [
      ["q", "Q"],
      ["c", "C"],
      ["h", "H"],
      ["p", "P"],
      ["v", "V"],
      ["k", "K"],
      ["y", "Y"],
      ["o", "O"],
      ["j", "J"],
      ["/", "?"],
      ["[", "{"],
      ["]", "}"],
      ["\\", "|"]
    ],
    "row3": [
      ["r", "R"],
      ["s", "S"],
      ["n", "N"],
      ["t", "T"],
      ["g", "G"],
      ["w", "W"],
      ["u", "U"],
      ["e", "E"],
      ["i", "I"],
      ["a", "A"],
      [";", ":"]
    ],
    "row4": [
      ["x", "X"],
      ["m", "M"],
      ["l", "L"],
      ["d", "D"],
      ["b", "B"],
      ["z", "Z"],
      ["f", "F"],
      ["'", "\""],
      [",", "<"],
      [".", ">"]
    ],
    "row5": [[" "]]
  }
}
