{
  "keymapShowTopRow": false,
  "type": "ansi",
  "keys": {
    "row1": [
      ["`", "~"],
      ["1", "!"],
      ["2", "@"],
      ["3", "#"],
      ["4", "$"],
      ["5", "%"],
      ["6", "^"],
      ["7", "&"],
      ["8", "*"],
      ["9", "("],
      ["0", ")"],
      ["-", "_"],
      ["=", "+"]
    ],
    "row2": [
      ["f", "F"],
      ["p", "P"],
      ["d", "D"],
      ["l", "L"],
      ["x", "X"],
      [";", ":"],
      ["u", "U"],
      ["o", "O"],
      ["y", "Y"],
      ["b", "B"],
      ["z", "Z"],
      ["]", "}"],
      ["\\", "|"]
    ],
    "row3": [
      ["s", "S"],
      ["n", "N"],
      ["t", "T"],
      ["h", "H"],
      ["k", "K"],
      [",", "<"],
      ["a", "A"],
      ["e", "E"],
      ["i", "I"],
      ["c", "C"],
      ["q", "Q"]
    ],
    "row4": [
      ["v", "V"],
      ["w", "W"],
      ["g", "G"],
      ["m", "M"],
      ["j", "J"],
      ["-", "_"],
      [".", ">"],
      ["'", "\""],
      ["=", "+"],
      ["/", "?"]
    ],
    "row5": [["r", "R"], [" "]]
  }
}
