{
  "keymapShowTopRow": false,
  "type": "ansi",
  "keys": {
    "row1": [
      ["`", "~"],
      ["1", "!"],
      ["2", "@"],
      ["3", "#"],
      ["4", "$"],
      ["5", "%"],
      ["6", "^"],
      ["7", "&"],
      ["8", "?"],
      ["9", "<"],
      ["0", ">"],
      ["=", "_"],
      ["\\", "|"]
    ],
    "row2": [
      ["w", "W"],
      ["f", "F"],
      ["m", "M"],
      ["p", "P"],
      ["v", "V"],
      ["/", "*"],
      [".", ":"],
      ["q", "Q"],
      ["\"", "["],
      ["'", "]"],
      ["z", "Z"],
      ["(", "{"],
      [")", "}"]
    ],
    "row3": [
      ["r", "R"],
      ["s", "S"],
      ["n", "N"],
      ["t", "T"],
      ["b", "B"],
      [",", ";"],
      ["a", "A"],
      ["e", "E"],
      ["i", "I"],
      ["h", "H"],
      ["j", "J"]
    ],
    "row4": [
      ["x", "X"],
      ["c", "C"],
      ["l", "L"],
      ["d", "D"],
      ["g", "G"],
      ["-", "+"],
      ["u", "U"],
      ["o", "O"],
      ["y", "Y"],
      ["k", "K"]
    ],
    "row5": [[" "]]
  }
}
