{
  "keymapShowTopRow": false,
  "type": "ansi",
  "keys": {
    "row1": [
      ["`", "~"],
      ["1", "!"],
      ["2", "@"],
      ["3", "#"],
      ["4", "$"],
      ["5", "%"],
      ["6", "^"],
      ["7", "&"],
      ["8", "*"],
      ["9", "("],
      ["0", ")"],
      ["-", "_"],
      ["=", "+"]
    ],
    "row2": [
      ["w", "W"],
      ["g", "G"],
      ["h", "H"],
      ["m", "M"],
      ["k", "K"],
      ["q", "Q"],
      ["c", "C"],
      ["u", "U"],
      ["j", "J"],
      ["'", "\""],
      ["[", "{"],
      ["]", "}"],
      ["\\", "|"]
    ],
    "row3": [
      ["r", "R"],
      ["s", "S"],
      ["n", "N"],
      ["t", "T"],
      ["f", "F"],
      ["y", "Y"],
      ["a", "A"],
      ["e", "E"],
      ["o", "O"],
      ["i", "I"],
      [";", ":"]
    ],
    "row4": [
      ["x", "X"],
      ["b", "B"],
      ["l", "L"],
      ["d", "D"],
      ["v", "V"],
      ["z", "Z"],
      ["p", "P"],
      [",", "<"],
      [".", ">"],
      ["/", "?"]
    ],
    "row5": [[" "]]
  }
}
