{
  "keymapShowTopRow": false,
  "type": "ansi",
  "keys": {
    "row1": [
      ["`", "~"],
      ["1", "!"],
      ["2", "@"],
      ["3", "#"],
      ["4", "$"],
      ["5", "%"],
      ["6", "^"],
      ["7", "&"],
      ["8", "*"],
      ["9", "("],
      ["0", ")"],
      ["-", "_"],
      ["=", "+"]
    ],
    "row2": [
      ["q", "Q"],
      ["u", "U"],
      ["o", "O"],
      ["p", "P"],
      ["z", "Z"],
      ["v", "V"],
      ["f", "F"],
      ["d", "D"],
      ["l", "L"],
      ["m", "M"],
      ["[", "{"],
      ["]", "}"],
      ["\\", "|"]
    ],
    "row3": [
      ["i", "I"],
      ["e", "E"],
      ["a", "A"],
      ["n", "N"],
      ["b", "B"],
      ["g", "G"],
      ["s", "S"],
      ["t", "T"],
      ["r", "R"],
      ["c", "C"],
      ["'", "\""]
    ],
    "row4": [
      [",", "<"],
      ["/", "?"],
      [".", ">"],
      ["h", "H"],
      [";", ":"],
      ["j", "J"],
      ["y", "Y"],
      ["k", "K"],
      ["x", "X"],
      ["w", "W"]
    ],
    "row5": [[" "]]
  }
}
