{
  "keymapShowTopRow": false,
  "type": "ansi",
  "keys": {
    "row1": [
      ["`", "~"],
      ["1", "!"],
      ["2", "@"],
      ["3", "#"],
      ["4", "$"],
      ["5", "%"],
      ["6", "^"],
      ["7", "&"],
      ["8", "*"],
      ["9", "("],
      ["0", ")"],
      ["-", "_"],
      ["=", "+"]
    ],
    "row2": [
      ["q", "Q"],
      ["g", "G"],
      ["d", "D"],
      ["v", "V"],
      ["x", "X"],
      ["j", "J"],
      ["y", "Y"],
      ["o", "O"],
      ["u", "U"],
      [";", ":"],
      ["[", "{"],
      ["]", "}"],
      ["\\", "|"]
    ],
    "row3": [
      ["r", "R"],
      ["s", "S"],
      ["t", "T"],
      ["h", "H"],
      ["l", "L"],
      ["p", "P"],
      ["n", "N"],
      ["a", "A"],
      ["i", "I"],
      ["e", "E"],
      ["'", "\""]
    ],
    "row4": [
      ["w", "W"],
      ["c", "C"],
      ["b", "B"],
      ["m", "M"],
      ["k", "K"],
      ["z", "Z"],
      ["f", "F"],
      [",", "<"],
      [".", ">"],
      ["/", "?"]
    ],
    "row5": [[" "]]
  }
}
