{
  "keymapShowTopRow": false,
  "type": "ansi",
  "keys": {
    "row1": [
      ["~", ";"],
      ["1", "!"],
      ["2", "@"],
      ["3", "#"],
      ["4", "$"],
      ["5", "%"],
      ["6", "^"],
      ["7", "&"],
      ["8", "*"],
      ["9", ")"],
      ["0", "("],
      ["-", "_"],
      ["=", "+"]
    ],
    "row2": [
      ["/", "Q"],
      ["'", "W"],
      ["ק", "E"],
      ["ר", "R"],
      ["א", "T"],
      ["ט", "Y"],
      ["ו", "U"],
      ["ן", "I"],
      ["ם", "O"],
      ["פ", "P"],
      ["]", "}"],
      ["[", "{"],
      ["\\", "|"]
    ],
    "row3": [
      ["ש", "A"],
      ["ד", "S"],
      ["ג", "D"],
      ["כ", "F"],
      ["ע", "G"],
      ["י", "H"],
      ["ח", "J"],
      ["ל", "K"],
      ["ך", "L"],
      ["ף", ":"],
      [",", "\""]
    ],
    "row4": [
      ["ז", "Z"],
      ["ס", "X"],
      ["ב", "C"],
      ["ה", "V"],
      ["נ", "B"],
      ["מ", "N"],
      ["צ", "M"],
      ["ת", ">"],
      ["ץ", "<"],
      [".", "?"]
    ],
    "row5": [[" "]]
  }
}
