{
  "keymapShowTopRow": true,
  "type": "ansi",
  "keys": {
    "row1": [
      ["ॊ", "ऒ"],
      ["1", "ऍ"],
      ["2", "ॅ"],
      ["3"],
      ["4"],
      ["5"],
      ["6"],
      ["7"],
      ["8"],
      ["9", "("],
      ["0", ")"],
      ["-", "ः"],
      ["ऋ", "ृ"]
    ],
    "row2": [
      ["ौ", "औ"],
      ["ै", "ऐ"],
      ["ा", "आ"],
      ["ी", "ई"],
      ["ू", "ऊ"],
      ["ब", "भ"],
      ["ह", "ङ"],
      ["ग", "घ"],
      ["द", "ध"],
      ["ज", "झ"],
      ["ड", "ढ"],
      ["़", "ञ"],
      ["ॉ", "ऑ"]
    ],
    "row3": [
      ["ो", "ओ"],
      ["े", "ए"],
      ["्", "अ"],
      ["ि", "इ"],
      ["ु", "उ"],
      ["प", "फ"],
      ["र", "ऱ"],
      ["क", "ख"],
      ["त", "थ"],
      ["च", "छ"],
      ["ट", "ठ"]
    ],
    "row4": [
      ["ॆ", "ऎ"],
      ["ं", "ँ"],
      ["म", "ण"],
      ["न"],
      ["व"],
      ["ल", "ळ"],
      ["स", "श"],
      [",", "ष"],
      [".", "।"],
      ["य", "य़"]
    ],
    "row5": [[" "]]
  }
}
