{
  "keymapShowTopRow": false,
  "type": "iso",
  "keys": {
    "row1": [
      ["`", "~"],
      ["1", "!"],
      ["2", "@"],
      ["3", "#"],
      ["4", "$"],
      ["5", "%"],
      ["6", "¨"],
      ["7", "&"],
      ["8", "*"],
      ["9", "("],
      ["0", ")"],
      ["[", "{"],
      ["]", "}"]
    ],
    "row2": [
      ["k", "K"],
      ["y", "Y"],
      ["o", "O"],
      ["u", "U"],
      ["'", "\""],
      ["v", "V"],
      ["d", "D"],
      ["l", "L"],
      ["p", "P"],
      ["w", "W"],
      ["/", "?"],
      ["|"]
    ],
    "row3": [
      ["h", "H"],
      ["i", "I"],
      ["e", "E"],
      ["a", "A"],
      ["-", "_"],
      ["c", "C"],
      ["s", "S"],
      ["t", "T"],
      ["n", "N"],
      ["r", "R"],
      ["x", "X"],
      ["\\"]
    ],
    "row4": [
      ["q", "Q"],
      ["j", "J"],
      [",", "<"],
      [".", ">"],
      [";", ":"],
      ["f", "F"],
      ["g", "G"],
      ["m", "M"],
      ["b", "B"],
      ["z", "Z"],
      ["=", "+"]
    ],
    "row5": [[" "]]
  }
}
