{
  "keymapShowTopRow": true,
  "type": "iso",
  "keys": {
    "row1": [
      ["0", "§"],
      ["1", "'"],
      ["2", "\""],
      ["3", "+"],
      ["4", "!"],
      ["5", "%"],
      ["6", "/"],
      ["7", "="],
      ["8", "("],
      ["9", ")"],
      ["ö", "Ö"],
      ["ü", "Ü"],
      ["ó", "Ó"]
    ],
    "row2": [
      ["q", "Q"],
      ["w", "W"],
      ["e", "E"],
      ["r", "R"],
      ["t", "T"],
      ["z", "Z"],
      ["u", "U"],
      ["i", "I"],
      ["o", "O"],
      ["p", "P"],
      ["ő", "Ő"],
      ["ú", "Ú"]
    ],
    "row3": [
      ["a", "A"],
      ["s", "S"],
      ["d", "D"],
      ["f", "F"],
      ["g", "G"],
      ["h", "H"],
      ["j", "J"],
      ["k", "K"],
      ["l", "L"],
      ["é", "É"],
      ["á", "Á"],
      ["ű", "Ű"]
    ],
    "row4": [
      ["í", "Í"],
      ["y", "Y"],
      ["x", "X"],
      ["c", "C"],
      ["v", "V"],
      ["b", "B"],
      ["n", "N"],
      ["m", "M"],
      [",", "?"],
      [".", ":"],
      ["-", "_"]
    ],
    "row5": [[" "]]
  }
}
