{
  "keymapShowTopRow": false,
  "type": "ansi",
  "keys": {
    "row1": [
      ["`", "~"],
      ["1", "!"],
      ["2", "@"],
      ["3", "#"],
      ["4", "$"],
      ["5", "%"],
      ["6", "^"],
      ["7", "&"],
      ["8", "*"],
      ["9", "("],
      ["0", ")"],
      ["-", "_"],
      ["=", "+"]
    ],
    "row2": [
      ["p", "P"],
      ["c", "C"],
      ["l", "L"],
      ["m", "M"],
      ["v", "V"],
      ["x", "X"],
      ["u", "U"],
      ["o", "O"],
      ["y", "Y"],
      ["f", "F"],
      ["[", "{"],
      ["]", "}"],
      ["\\", "|"]
    ],
    "row3": [
      ["n", "N"],
      ["s", "S"],
      ["r", "R"],
      ["t", "T"],
      ["d", "D"],
      [".", ">"],
      ["a", "A"],
      ["e", "E"],
      ["i", "I"],
      ["h", "H"],
      [";", ":"]
    ],
    "row4": [
      ["b", "B"],
      ["g", "G"],
      ["'", "\""],
      ["w", "W"],
      ["z", "Z"],
      ["/", "?"],
      [",", "<"],
      ["q", "Q"],
      ["j", "J"],
      ["k", "K"]
    ],
    "row5": [[" "]]
  }
}
