{
  "keymapShowTopRow": false,
  "type": "ansi",
  "keys": {
    "row1": [
      ["`", "~"],
      ["1", "["],
      ["2", "]"],
      ["3", "#"],
      ["4", "$"],
      ["5", "%"],
      ["6", "^"],
      ["7", "&"],
      ["8", "*"],
      ["9", "{"],
      ["0", "}"],
      ["q", "Q"],
      ["x", "X"]
    ],
    "row2": [
      ["!", "+"],
      ["p", "P"],
      ["u", "U"],
      ["o", "O"],
      ["-", "_"],
      ["j", "J"],
      ["b", "B"],
      ["l", "L"],
      ["m", "M"],
      ["y", "Y"],
      ["z", "Z"],
      ["v", "V"],
      ["\\", "|"]
    ],
    "row3": [
      ["i", "I"],
      ["n", "N"],
      ["e", "E"],
      ["a", "A"],
      [",", ";"],
      ["d", "D"],
      ["t", "T"],
      ["k", "K"],
      ["r", "R"],
      ["s", "S"],
      ["'", "\""]
    ],
    "row4": [
      ["=", "("],
      ["@", ")"],
      [":", "<"],
      [".", ">"],
      ["?", "/"],
      ["g", "G"],
      ["h", "H"],
      ["c", "C"],
      ["w", "W"],
      ["f", "F"]
    ],
    "row5": [[" "]]
  }
}
