{
  "keymapShowTopRow": false,
  "type": "ansi",
  "keys": {
    "row1": [
      ["`", "~"],
      ["1", "!"],
      ["2", "@"],
      ["3", "#"],
      ["4", "$"],
      ["5", "%"],
      ["6", "^"],
      ["7", "&"],
      ["8", "*"],
      ["9", "("],
      ["0", ")"],
      ["-", "_"],
      ["=", "+"]
    ],
    "row2": [
      ["t", "T"],
      ["r", "R"],
      ["e", "E"],
      ["w", "W"],
      ["q", "Q"],
      ["p", "P"],
      ["o", "O"],
      ["i", "I"],
      ["u", "U"],
      ["y", "Y"],
      ["[", "{"],
      ["]", "}"],
      ["\\", "|"]
    ],
    "row3": [
      ["g", "G"],
      ["f", "F"],
      ["d", "D"],
      ["s", "S"],
      ["a", "A"],
      [";", ":"],
      ["l", "L"],
      ["k", "K"],
      ["j", "J"],
      ["h", "H"],
      ["'", "\""]
    ],
    "row4": [
      ["b", "B"],
      ["v", "V"],
      ["c", "C"],
      ["x", "X"],
      ["z", "Z"],
      ["/", "?"],
      [".", ">"],
      [",", "<"],
      ["m", "M"],
      ["n", "N"]
    ],
    "row5": [[" "]]
  }
}
