{
  "keymapShowTopRow": false,
  "type": "ansi",
  "keys": {
    "row1": [
      ["`", "~"],
      ["1", "!"],
      ["2", "@"],
      ["3", "#"],
      ["4", "$"],
      ["5", "%"],
      ["6", "^"],
      ["7", "&"],
      ["8", "*"],
      ["9", "("],
      ["0", ")"],
      ["-", "_"],
      ["=", "+"]
    ],
    "row2": [
      ["f", "F"],
      ["o", "O"],
      ["u", "U"],
      ["m", "M"],
      ["j", "J"],
      ["q", "Q"],
      ["g", "G"],
      ["d", "D"],
      ["p", "P"],
      [",", "<"],
      ["[", "{"],
      ["]", "}"],
      ["\\", "|"]
    ],
    "row3": [
      ["h", "H"],
      ["a", "A"],
      ["e", "E"],
      ["r", "R"],
      ["x", "X"],
      ["v", "V"],
      ["s", "S"],
      ["t", "T"],
      ["n", "N"],
      ["i", "I"],
      [";", ":"]
    ],
    "row4": [
      ["'", "\""],
      ["/", "?"],
      ["l", "L"],
      ["w", "W"],
      ["z", "Z"],
      ["y", "Y"],
      ["c", "C"],
      ["k", "K"],
      ["b", "B"],
      [".", ">"]
    ],
    "row5": [[" "]]
  }
}
