{
  "keymapShowTopRow": false,
  "type": "ansi",
  "keys": {
    "row1": [
      ["`", "~"],
      ["1", "!"],
      ["2", "@"],
      ["3", "#"],
      ["4", "$"],
      ["5", "%"],
      ["6", "^"],
      ["7", "&"],
      ["8", "*"],
      ["9", "("],
      ["0", ")"],
      ["-", "_"],
      ["=", "+"]
    ],
    "row2": [
      ["y", "Y"],
      ["c", "C"],
      ["l", "L"],
      ["m", "M"],
      ["k", "K"],
      ["z", "Z"],
      ["f", "F"],
      ["u", "U"],
      [",", "<"],
      ["'", "\""],
      ["[", "{"],
      ["]", "}"],
      ["\\", "|"]
    ],
    "row3": [
      ["i", "I"],
      ["s", "S"],
      ["r", "R"],
      ["t", "T"],
      ["g", "G"],
      ["p", "P"],
      ["n", "N"],
      ["e", "E"],
      ["a", "A"],
      ["o", "O"],
      [";", ":"]
    ],
    "row4": [
      ["v", "V"],
      ["w", "W"],
      ["d", "D"],
      ["j", "J"],
      ["q", "Q"],
      ["b", "B"],
      ["h", "H"],
      ["/", "?"],
      [".", ">"],
      ["x", "X"]
    ],
    "row5": [[" "]]
  }
}
