{
  "keymapShowTopRow": true,
  "type": "ansi",
  "keys": {
    "row1": [
      ["ё", "Ё"],
      ["1", "!"],
      ["2", "\""],
      ["3", "№"],
      ["4", ";"],
      ["5", "%"],
      ["6", ":"],
      ["7", "?"],
      ["8", "*"],
      ["9", "("],
      ["0", ")"],
      ["-", "_"],
      ["=", "+"]
    ],
    "row2": [
      ["й", "Й"],
      ["у", "У"],
      ["и", "И"],
      ["я", "Я"],
      ["ф", "Ф"],
      ["х", "Х"],
      ["ж", "Ж"],
      ["р", "Р"],
      [".", ","],
      ["ш", "Ш"],
      ["ц", "Ц"],
      ["Ь", "Ъ"],
      ["\\", "/"]
    ],
    "row3": [
      ["в", "В"],
      ["е", "Е"],
      ["а", "А"],
      ["о", "О"],
      ["ч", "Ч"],
      ["г", "Г"],
      ["т", "Т"],
      ["н", "Н"],
      ["с", "С"],
      ["д", "Д"],
      ["б", "Б"]
    ],
    "row4": [
      ["ь", "ъ"],
      ["э", "Э"],
      ["ю", "Ю"],
      ["ы", "Ы"],
      ["щ", "Щ"],
      ["п", "П"],
      ["к", "К"],
      ["л", "Л"],
      ["з", "З"],
      ["м", "М"]
    ],
    "row5": [[" "]]
  }
}
