{
  "keymapShowTopRow": false,
  "type": "ansi",
  "keys": {
    "row1": [
      ["`", "~"],
      ["1", "!"],
      ["2", "@"],
      ["3", "#"],
      ["4", "$"],
      ["5", "%"],
      ["6", "^"],
      ["7", "&"],
      ["8", "*"],
      ["9", "("],
      ["0", ")"],
      ["-", "_"],
      ["=", "+"]
    ],
    "row2": [
      ["ㅂ", "ㅃ"],
      ["ㅈ", "ㅉ"],
      ["ㄷ", "ㄸ"],
      ["ㄱ", "ㄲ"],
      ["ㅅ", "ㅆ"],
      ["ㅛ", "ㅛ"],
      ["ㅕ", "ㅕ"],
      ["ㅑ", "ㅑ"],
      ["ㅐ", "ㅒ"],
      ["ㅔ", "ㅖ"],
      ["[", "{"],
      ["]", "}"],
      ["\\", "|"]
    ],
    "row3": [
      ["ㅁ", "ㅁ"],
      ["ㄴ", "ㄴ"],
      ["ㅇ", "ㅇ"],
      ["ㄹ", "ㄹ"],
      ["ㅎ", "ㅎ"],
      ["ㅗ", "ㅗ"],
      ["ㅓ", "ㅓ"],
      ["ㅏ", "ㅏ"],
      ["ㅣ", "ㅣ"],
      [";", ":"],
      ["'", "\""]
    ],
    "row4": [
      ["ㅋ", "ㅋ"],
      ["ㅌ", "ㅌ"],
      ["ㅊ", "ㅊ"],
      ["ㅍ", "ㅍ"],
      ["ㅠ", "ㅠ"],
      ["ㅜ", "ㅜ"],
      ["ㅡ", "ㅡ"],
      [",", "<"],
      [".", ">"],
      ["/", "?"]
    ],
    "row5": [[" "]]
  }
}
