{
  "keymapShowTopRow": false,
  "type": "ansi",
  "keys": {
    "row1": [
      ["`", "~"],
      ["1", "!"],
      ["2", "@"],
      ["3", "#"],
      ["4", "$"],
      ["5", "%"],
      ["6", "^"],
      ["7", "&"],
      ["8", "*"],
      ["9", "("],
      ["0", ")"],
      ["-", "_"],
      ["=", "+"]
    ],
    "row2": [
      ["ㅇ", "ㅇ"],
      ["ㅡ", "ㅡ"],
      ["ㅔ", "ㅖ"],
      ["ㄹ", "ㄹ"],
      ["ㅌ", "ㅌ"],
      ["ㅐ", "ㅒ"],
      ["ㅜ", "ㅜ"],
      ["ㅣ", "ㅣ"],
      ["ㅗ", "ㅗ"],
      ["ㅍ", "ㅍ"],
      ["[", "{"],
      ["]", "}"],
      ["\\", "|"]
    ],
    "row3": [
      ["ㅏ", "ㅏ"],
      ["ㅅ", "ㅆ"],
      ["ㄷ", "ㄸ"],
      ["ㅑ", "ㅑ"],
      ["ㄱ", "ㄲ"],
      ["ㅎ", "ㅎ"],
      ["ㅈ", "ㅉ"],
      ["ㅋ", "ㅋ"],
      ["ㅛ", "ㅛ"],
      [";", ":"],
      ["'", "\""]
    ],
    "row4": [
      ["ㅕ", "ㅕ"],
      ["ㅠ", "ㅠ"],
      ["ㅊ", "ㅊ"],
      ["ㅓ", "ㅓ"],
      ["ㅂ", "ㅃ"],
      ["ㄴ", "ㄴ"],
      ["ㅁ", "ㅁ"],
      [",", "<"],
      [".", ">"],
      ["/", "?"]
    ],
    "row5": [[" "]]
  }
}
