{
  "keymapShowTopRow": false,
  "type": "iso",
  "keys": {
    "row1": [
      ["^", "ˇ"],
      ["1", "°"],
      ["2", "§"],
      ["3", "ℓ"],
      ["4", "»"],
      ["5", "«"],
      ["6", "$"],
      ["7", "€"],
      ["8", "„"],
      ["9", "“"],
      ["0", "”"],
      ["-", "—"],
      ["`", "¸"]
    ],
    "row2": [
      ["k", "K"],
      [".", "•"],
      ["o", "O"],
      [",", "–"],
      ["y", "Y"],
      ["v", "V"],
      ["g", "G"],
      ["c", "C"],
      ["l", "L"],
      ["ß", "ẞ"],
      ["z", "Z"],
      ["'", "~"]
    ],
    "row3": [
      ["h", "H"],
      ["a", "A"],
      ["e", "E"],
      ["i", "I"],
      ["u", "U"],
      ["d", "D"],
      ["t", "T"],
      ["r", "R"],
      ["n", "N"],
      ["s", "S"],
      ["f", "F"],
      [" "]
    ],
    "row4": [
      [" "],
      ["x", "X"],
      ["q", "Q"],
      ["ä", "Ä"],
      ["ü", "Ü"],
      ["ö", "Ö"],
      ["b", "B"],
      ["p", "P"],
      ["w", "W"],
      ["m", "M"],
      ["j", "J"]
    ],
    "row5": [[" "]]
  }
}
