{
  "keymapShowTopRow": false,
  "type": "ansi",
  "keys": {
    "row1": [
      ["`", "~"],
      ["1", "!"],
      ["2", "@"],
      ["3", "#"],
      ["4", "$"],
      ["5", "%"],
      ["6", "^"],
      ["7", "&"],
      ["8", "*"],
      ["9", "("],
      ["0", ")"],
      ["-", "_"],
      ["=", "+"]
    ],
    "row2": [
      ["v", "V"],
      ["l", "L"],
      ["n", "N"],
      ["d", "D"],
      ["k", "K"],
      ["q", "Q"],
      ["w", "W"],
      ["o", "O"],
      ["u", "U"],
      ["j", "J"],
      ["[", "{"],
      ["]", "}"],
      ["\\", "|"]
    ],
    "row3": [
      ["t", "T"],
      ["s", "S"],
      ["r", "R"],
      ["h", "H"],
      ["f", "F"],
      ["g", "G"],
      ["c", "C"],
      ["a", "A"],
      ["i", "I"],
      ["e", "E"],
      [";", ":"]
    ],
    "row4": [
      ["z", "Z"],
      ["x", "X"],
      ["p", "P"],
      ["b", "B"],
      ["'", "\""],
      ["m", "M"],
      ["y", "Y"],
      [".", ">"],
      [",", "<"],
      ["/", "?"]
    ],
    "row5": [[" "]]
  }
}
