{
  "keymapShowTopRow": false,
  "type": "ansi",
  "keys": {
    "row1": [
      ["ѝ", "Ѝ"],
      ["1", "!"],
      ["2", "„"],
      ["3", "“"],
      ["4", "'"],
      ["5", "%"],
      ["6", "‚"],
      ["7", "‘"],
      ["8", "*"],
      ["9", "("],
      ["0", ")"],
      ["-", "-"],
      ["=", "+"]
    ],
    "row2": [
      ["љ", "Љ"],
      ["њ", "Њ"],
      ["е", "Е"],
      ["р", "Р"],
      ["т", "Т"],
      ["ѕ", "Ѕ"],
      ["у", "У"],
      ["и", "И"],
      ["о", "О"],
      ["п", "П"],
      ["ш", "Ш"],
      ["ѓ", "Ѓ"],
      ["ж", "Ж"]
    ],
    "row3": [
      ["а", "А"],
      ["с", "С"],
      ["д", "Д"],
      ["ф", "Ф"],
      ["г", "Г"],
      ["х", "Х"],
      ["ј", "Ј"],
      ["к", "К"],
      ["л", "Л"],
      ["ч", "Ч"],
      ["ќ", "Ќ"]
    ],
    "row4": [
      ["з", "З"],
      ["џ", "Џ"],
      ["ц", "Ц"],
      ["в", "В"],
      ["б", "Б"],
      ["н", "Н"],
      ["м", "М"],
      [",", ";"],
      [".", ":"],
      ["/", "?"]
    ],
    "row5": [[" "]]
  }
}
