{
  "keymapShowTopRow": false,
  "type": "ansi",
  "keys": {
    "row1": [
      ["`", "~"],
      ["1", "!"],
      ["2", "@"],
      ["3", "#"],
      ["4", "$"],
      ["5", "%"],
      ["6", "^"],
      ["7", "&"],
      ["8", "*"],
      ["9", "("],
      ["0", ")"],
      ["-", "_"],
      ["=", "+"]
    ],
    "row2": [
      ["q", "Q"],
      ["p", "P"],
      ["y", "Y"],
      ["c", "C"],
      ["b", "B"],
      ["v", "V"],
      ["m", "M"],
      ["u", "U"],
      ["z", "Z"],
      ["l", "L"],
      ["[", "{"],
      ["]", "}"],
      ["\\", "|"]
    ],
    "row3": [
      ["a", "A"],
      ["n", "N"],
      ["i", "I"],
      ["s", "S"],
      ["f", "F"],
      ["d", "D"],
      ["t", "T"],
      ["h", "H"],
      ["o", "O"],
      ["r", "R"],
      ["'", "\""]
    ],
    "row4": [
      [",", "<"],
      [".", ">"],
      ["j", "J"],
      ["g", "G"],
      ["'", "\""],
      ["/", "?"],
      ["w", "W"],
      ["k", "K"],
      ["-", "_"],
      ["x", "X"]
    ],
    "row5": [["e", "E"], [" "]]
  }
}
