{
  "keymapShowTopRow": true,
  "type": "iso",
  "keys": {
    "row1": [
      ["`", "~"],
      ["1", "!"],
      ["2", "\""],
      ["3", "#"],
      ["4", "$"],
      ["5", "%"],
      ["6", "&"],
      ["7", "'"],
      ["8", "("],
      ["9", ")"],
      ["0", "~"],
      ["^", "~"],
      ["]", "}"]
    ],
    "row2": [
      ["b", "B"],
      ["w", "W"],
      ["l", "L"],
      ["u", "U"],
      ["[", "{"],
      ["]", "}"],
      ["o", "o"],
      ["f", "f"],
      ["g", "g"],
      ["y", "y"],
      ["k", "k"],
      ["=", "+"],
      ["\\", "|"]
    ],
    "row3": [
      ["d", "D"],
      ["a", "A"],
      ["t", "T"],
      ["s", "S"],
      [";", "+"],
      [":", "*"],
      ["e", "E"],
      ["i", "I"],
      ["r", "R"],
      ["n", "N"],
      ["q", "Q"]
    ],
    "row4": [
      ["z", "Z"],
      ["x", "X"],
      ["c", "C"],
      ["v", "V"],
      [",", "<"],
      [".", ">"],
      ["h", "H"],
      ["m", "M"],
      ["j", "J"],
      ["p", "P"],
      ["@","`"]
    ],
    "row5": [[" "]]
  }
}
