{
  "keymapShowTopRow": false,
  "type": "iso",
  "keys": {
    "row1": [
      ["^", "ˇ"],
      ["1", "°"],
      ["2", "§"],
      ["3", "ℓ"],
      ["4", "»"],
      ["5", "«"],
      ["6", "$"],
      ["7", "€"],
      ["8", "„"],
      ["9", "“"],
      ["0", "”"],
      ["-", "—"],
      ["`", "¸"]
    ],
    "row2": [
      ["j", "J"],
      ["l", "L"],
      ["u", "U"],
      ["a", "A"],
      ["q", "Q"],
      ["w", "W"],
      ["b", "B"],
      ["d", "D"],
      ["g", "G"],
      ["y", "Y"],
      ["z", "Z"],
      ["ß", "ẞ"]
    ],
    "row3": [
      ["c", "C"],
      ["r", "R"],
      ["i", "I"],
      ["e", "E"],
      ["o", "O"],
      ["m", "M"],
      ["n", "N"],
      ["t", "T"],
      ["s", "S"],
      ["h", "H"],
      [" "],
      ["'", "~"]
    ],
    "row4": [
      [" "],
      ["v", "V"],
      ["x", "X"],
      ["ü", "Ü"],
      ["ä", "Ä"],
      ["ö", "Ö"],
      ["p", "P"],
      ["f", "F"],
      [",", "–"],
      [".", "•"],
      ["k", "K"]
    ],
    "row5": [[" "]]
  }
}
