{
  "keymapShowTopRow": true,
  "type": "ansi",
  "keys": {
    "row1": [
      ["=", "+"],
      ["№", "1"],
      ["-", "2"],
      ["\"", "3"],
      ["₮", "4"],
      [":", "5"],
      [".", "6"],
      ["_", "7"],
      [",", "8"],
      ["%", "9"],
      ["?", "0"],
      ["е", "Е"],
      ["щ", "Щ"]
    ],
    "row2": [
      ["ф", "Ф"],
      ["ц", "Ц"],
      ["у", "У"],
      ["ж", "Ж"],
      ["э", "Э"],
      ["н", "Н"],
      ["г", "Г"],
      ["ш", "Ш"],
      ["ү", "Ү"],
      ["з", "З"],
      ["к", "К"],
      ["ъ", "Ъ"],
      ["\\", "|"]
    ],
    "row3": [
      ["й", "Й"],
      ["ы", "Ы"],
      ["б", "Б"],
      ["ө", "Ө"],
      ["а", "А"],
      ["х", "Х"],
      ["р", "Р"],
      ["о", "О"],
      ["л", "Л"],
      ["д", "Д"],
      ["п", "П"]
    ],
    "row4": [
      ["я", "Я"],
      ["ч", "Ч"],
      ["ё", "Ё"],
      ["с", "С"],
      ["м", "М"],
      ["и", "И"],
      ["т", "Т"],
      ["ь", "Ь"],
      ["в", "В"],
      ["ю", "Ю"]
    ],
    "row5": [[" "]]
  }
}
