{
  "keymapShowTopRow": true,
  "type": "ansi",
  "keys": {
    "row1": [
      ["\\", "^"],
      ["1", "~"],
      ["2", "["],
      ["3", "{"],
      ["4", "<"],
      ["5", "|"],
      ["6", "#"],
      ["7", ">"],
      ["8", "}"],
      ["9", "]"],
      ["0", "%"],
      ["q", "Q"],
      ["z", "Z"]
    ],
    "row2": [
      ["y", "Y"],
      ["p", "P"],
      ["o", "O"],
      ["u", "U"],
      ["-", "="],
      ["k", "K"],
      ["d", "D"],
      ["l", "L"],
      ["c", "C"],
      ["w", "W"],
      ["x", "X"],
      ["/", "+"],
      ["$", "@"]
    ],
    "row3": [
      ["i", "I"],
      ["n", "N"],
      ["e", "E"],
      ["a", "A"],
      [",", ":"],
      ["m", "M"],
      ["h", "H"],
      ["t", "T"],
      ["s", "S"],
      ["r", "R"],
      ["\"", "!"]
    ],
    "row4": [
      ["(", "`"],
      [")", "?"],
      ["'", "*"],
      [".", ";"],
      ["_", "&"],
      ["b", "B"],
      ["f", "F"],
      ["g", "G"],
      ["v", "V"],
      ["j", "J"]
    ],
    "row5": [[" "]]
  }
}
