{
  "keymapShowTopRow": false,
  "type": "ansi",
  "keys": {
    "row1": [
      ["`", "~"],
      ["1", "!"],
      ["2", "@"],
      ["3", "#"],
      ["4", "$"],
      ["5", "%"],
      ["6", "^"],
      ["7", "&"],
      ["8", "*"],
      ["9", "("],
      ["0", ")"],
      ["-", "_"],
      ["=", "+"]
    ],
    "row2": [
      ["y", "Y"],
      ["p", "P"],
      ["o", "O"],
      ["u", "U"],
      ["j", "J"],
      ["k", "K"],
      ["d", "D"],
      ["l", "L"],
      ["c", "C"],
      ["w", "W"],
      ["[", "{"],
      ["]", "}"],
      ["\\", "|"]
    ],
    "row3": [
      ["i", "I"],
      ["n", "N"],
      ["e", "E"],
      ["a", "A"],
      [",", ";"],
      ["m", "M"],
      ["h", "H"],
      ["t", "T"],
      ["s", "S"],
      ["r", "R"],
      ["'", "\""]
    ],
    "row4": [
      ["q", "Q"],
      ["z", "Z"],
      ["/", "<"],
      [".", ">"],
      [":", "?"],
      ["b", "B"],
      ["f", "F"],
      ["g", "G"],
      ["v", "V"],
      ["x", "X"]
    ],
    "row5": [[" "]]
  }
}
