{
  "keymapShowTopRow": false,
  "type": "ansi",
  "keys": {
    "row1": [
      ["`", "~"],
      ["1", "!"],
      ["2", "@"],
      ["3", "#"],
      ["4", "$"],
      ["5", "%"],
      ["6", "^"],
      ["7", "&"],
      ["8", "*"],
      ["9", "("],
      ["0", ")"],
      ["-", "_"],
      ["=", "+"]
    ],
    "row2": [
      ["q", "Q"],
      ["w", "W"],
      ["l", "L"],
      ["d", "D"],
      ["b", "B"],
      ["j", "J"],
      ["f", "F"],
      ["u", "U"],
      ["k", "K"],
      ["p", "P"],
      ["[", "{"],
      ["]", "}"],
      ["\\", "|"]
    ],
    "row3": [
      ["a", "A"],
      ["s", "S"],
      ["r", "R"],
      ["t", "T"],
      ["g", "G"],
      ["h", "H"],
      ["n", "N"],
      ["e", "E"],
      ["o", "O"],
      ["i", "I"],
      ["/", "?"]
    ],
    "row4": [
      ["z", "Z"],
      ["x", "X"],
      ["c", "C"],
      ["v", "V"],
      [";", ":"],
      ["y", "Y"],
      ["m", "M"],
      [",", "<"],
      [".", ">"],
      ["'", "\""]
    ],
    "row5": [[" "]]
  }
}
