{
  "keymapShowTopRow": false,
  "type": "iso",
  "keys": {
    "row1": [
      ["^", "ˇ"],
      ["1", "°"],
      ["2", "§"],
      ["3", "ℓ"],
      ["4", "»"],
      ["5", "«"],
      ["6", "$"],
      ["7", "€"],
      ["8", "„"],
      ["9", "“"],
      ["0", "”"],
      ["-", "—"],
      ["`", "¸"]
    ],
    "row2": [
      ["x", "X"],
      ["v", "V"],
      ["l", "L"],
      ["c", "C"],
      ["w", "W"],
      ["k", "K"],
      ["h", "H"],
      ["g", "G"],
      ["f", "F"],
      ["q", "Q"],
      ["ß", "ẞ"],
      ["'", "~"]
    ],
    "row3": [
      ["u", "U"],
      ["i", "I"],
      ["a", "A"],
      ["e", "E"],
      ["o", "O"],
      ["s", "S"],
      ["n", "N"],
      ["r", "R"],
      ["t", "T"],
      ["d", "D"],
      ["y", "Y"],
      [" "]
    ],
    "row4": [
      [" "],
      ["ü", "Ü"],
      ["ö", "Ö"],
      ["ä", "Ä"],
      ["p", "P"],
      ["z", "Z"],
      ["b", "B"],
      ["m", "M"],
      [",", "–"],
      [".", "•"],
      ["j", "J"]
    ],
    "row5": [[" "]]
  }
}
