{
  "keymapShowTopRow": false,
  "type": "ansi",
  "keys": {
    "row1": [
      ["`", "~"],
      ["1", "!"],
      ["2", "@"],
      ["3", "#"],
      ["4", "$"],
      ["5", "%"],
      ["6", "^"],
      ["7", "&"],
      ["8", "*"],
      ["9", "("],
      ["0", ")"],
      ["-", "_"],
      ["=", "+"]
    ],
    "row2": [
      ["x", "X"],
      ["l", "L"],
      ["d", "D"],
      ["p", "P"],
      ["v", "V"],
      ["z", "Z"],
      ["k", "K"],
      ["o", "O"],
      ["u", "U"],
      [";", ":"],
      ["[", "{"],
      ["]", "}"],
      ["\\", "|"]
    ],
    "row3": [
      ["n", "N"],
      ["r", "R"],
      ["t", "T"],
      ["s", "S"],
      ["g", "G"],
      ["y", "Y"],
      ["h", "H"],
      ["e", "E"],
      ["i", "I"],
      ["a", "A"],
      ["/", "?"]
    ],
    "row4": [
      ["j", "J"],
      ["m", "M"],
      ["c", "C"],
      ["w", "W"],
      ["q", "Q"],
      ["b", "B"],
      ["f", "F"],
      ["'", "\""],
      [",", "<"],
      [".", ">"]
    ],
    "row5": [[" "]]
  }
}
