{
  "keymapShowTopRow": false,
  "type": "ansi",
  "keys": {
    "row1": [
      ["`", "~"],
      ["1", "!"],
      ["2", "@"],
      ["3", "#"],
      ["4", "$"],
      ["5", "%"],
      ["6", "^"],
      ["7", "&"],
      ["8", "*"],
      ["9", "("],
      ["0", ")"],
      ["=", "+"],
      ["\\", "|"]
    ],
    "row2": [
      ["b", "B"],
      ["f", "F"],
      ["l", "L"],
      ["k", "K"],
      ["q", "Q"],
      ["'", "\""],
      ["g", "G"],
      ["o", "O"],
      ["u", "U"],
      [".", ">"],
      [";", ":"],
      ["[", "{"],
      ["]", "}"]
    ],
    "row3": [
      ["n", "N"],
      ["s", "S"],
      ["h", "H"],
      ["t", "T"],
      ["m", "M"],
      ["y", "Y"],
      ["c", "C"],
      ["a", "A"],
      ["e", "E"],
      ["i", "I"],
      ["/", "?"]
    ],
    "row4": [
      ["v", "V"],
      ["j", "J"],
      ["d", "D"],
      ["r", "R"],
      ["z", "Z"],
      ["p", "P"],
      ["w", "W"],
      ["x", "X"],
      ["-", "_"],
      [",", "<"]
    ],
    "row5": [[" "]]
  }
}
