{
  "keymapShowTopRow": false,
  "type": "ansi",
  "keys": {
    "row1": [
      ["`", "~"],
      ["1", "!"],
      ["2", "@"],
      ["3", "#"],
      ["4", "$"],
      ["5", "%"],
      ["6", "^"],
      ["7", "&"],
      ["8", "*"],
      ["9", "("],
      ["0", ")"],
      ["-", "_"],
      ["=", "+"]
    ],
    "row2": [
      ["b", "B"],
      ["f", "F"],
      ["l", "L"],
      ["d", "D"],
      ["v", "V"],
      ["y", "Y"],
      ["p", "P"],
      ["o", "O"],
      ["u", "U"],
      ["/", "?"],
      ["[", "{"],
      ["]", "}"],
      ["\\", "|"]
    ],
    "row3": [
      ["n", "N"],
      ["s", "S"],
      ["h", "H"],
      ["t", "T"],
      ["m", "M"],
      ["g", "G"],
      ["c", "C"],
      ["a", "A"],
      ["e", "E"],
      ["i", "I"],
      ["-", "_"]
    ],
    "row4": [
      ["q", "Q"],
      ["x", "X"],
      ["j", "J"],
      ["k", "K"],
      ["z", "Z"],
      ["'", "\""],
      ["w", "W"],
      [",", "<"],
      [";", ":"],
      [".", ">"]
    ],
    "row5": [[" "]]
  }
}
