{
  "keymapShowTopRow": false,
  "type": "ansi",
  "keys": {
    "row1": [
      ["`", "~"],
      ["1", "!"],
      ["2", "@"],
      ["3", "#"],
      ["4", "$"],
      ["5", "%"],
      ["6", "^"],
      ["7", "&"],
      ["8", "*"],
      ["9", "("],
      ["0", ")"],
      ["[", "{"],
      ["]", "}"]
    ],
    "row2": [
      ["x", "X"],
      ["d", "D"],
      ["l", "L"],
      ["g", "G"],
      ["v", "V"],
      ["j", "J"],
      ["f", "F"],
      ["o", "O"],
      ["u", "U"],
      [",", "<"],
      [";", ":"],
      ["=", "+"],
      ["\\", "|"]
    ],
    "row3": [
      ["r", "R"],
      ["t", "T"],
      ["n", "N"],
      ["s", "S"],
      ["b", "B"],
      ["q", "Q"],
      ["h", "H"],
      ["a", "A"],
      ["e", "E"],
      ["i", "I"],
      ["-", "_"]
    ],
    "row4": [
      ["k", "K"],
      ["m", "M"],
      ["c", "C"],
      ["w", "W"],
      ["z", "Z"],
      ["p", "P"],
      ["y", "Y"],
      ["'", "\""],
      ["/", "?"],
      [".", ">"]
    ],
    "row5": [[" "]]
  }
}
