{
  "keymapShowTopRow": false,
  "type": "ansi",
  "keys": {
    "row1": [
      ["`", "~"],
      ["1", "!"],
      ["2", "@"],
      ["3", "#"],
      ["4", "$"],
      ["5", "%"],
      ["6", "^"],
      ["7", "&"],
      ["8", "*"],
      ["9", "("],
      ["0", ")"],
      ["[", "{"],
      ["]", "}"]
    ],
    "row2": [
      ["z", "Z"],
      ["m", "M"],
      ["r", "R"],
      ["l", "L"],
      ["f", "F"],
      ["j", "J"],
      ["y", "Y"],
      ["o", "O"],
      ["u", "U"],
      ["'", "<"],
      ["-", ":"],
      ["=", ">"],
      ["\\", "|"]
    ],
    "row3": [
      ["n", "N"],
      ["t", "T"],
      ["h", "H"],
      ["s", "S"],
      ["b", "B"],
      ["c", "C"],
      ["d", "D"],
      ["e", "E"],
      ["i", "I"],
      ["a", "A"],
      [",", "\""]
    ],
    "row4": [
      ["x", "X"],
      ["q", "Q"],
      ["w", "W"],
      ["k", "K"],
      ["v", "V"],
      ["p", "P"],
      ["g", "G"],
      ["/", "+"],
      [".", "_"],
      [";", "?"]
    ],
    "row5": [[" "]]
  }
}
