{
  "keymapShowTopRow": false,
  "type": "iso",
  "keys": {
    "row1": [
      ["^", "ˇ"],
      ["1", "°"],
      ["2", "§"],
      ["3", "ℓ"],
      ["4", "»"],
      ["5", "«"],
      ["6", "$"],
      ["7", "€"],
      ["8", "„"],
      ["9", "“"],
      ["0", "”"],
      ["-", "—"],
      ["`", "¸"]
    ],
    "row2": [
      ["z", "Z"],
      ["y", "Y"],
      ["u", "U"],
      ["a", "A"],
      ["q", "Q"],
      ["p", "P"],
      ["b", "B"],
      ["m", "M"],
      ["l", "L"],
      ["f", "F"],
      ["j", "J"],
      ["ß", "ẞ"]
    ],
    "row3": [
      ["c", "C"],
      ["s", "S"],
      ["i", "I"],
      ["e", "E"],
      ["o", "O"],
      ["d", "D"],
      ["t", "T"],
      ["n", "N"],
      ["r", "R"],
      ["h", "H"],
      [" "],
      ["'", "~"]
    ],
    "row4": [
      [" "],
      ["v", "V"],
      ["x", "X"],
      ["ü", "Ü"],
      ["ä", "Ä"],
      ["ö", "Ö"],
      ["w", "W"],
      ["g", "G"],
      [",", "–"],
      [".", "•"],
      ["k", "K"]
    ],
    "row5": [[" "]]
  }
}
