{
  "keymapShowTopRow": false,
  "type": "ansi",
  "keys": {
    "row1": [
      ["`", "~"],
      ["1", "!"],
      ["2", "@"],
      ["3", "#"],
      ["4", "$"],
      ["5", "%"],
      ["6", "^"],
      ["7", "&"],
      ["8", "*"],
      ["9", "("],
      ["0", ")"],
      ["-", "_"],
      ["=", "+"]
    ],
    "row2": [
      ["y", "Y"],
      ["o", "O"],
      ["u", "U"],
      ["k", "K"],
      ["x", "X"],
      ["g", "G"],
      ["w", "W"],
      ["d", "D"],
      ["l", "L"],
      [",", "<"],
      ["[", "{"],
      ["]", "}"],
      ["\\", "|"]
    ],
    "row3": [
      ["i", "I"],
      ["a", "A"],
      ["e", "E"],
      ["n", "N"],
      ["f", "F"],
      ["b", "B"],
      ["s", "S"],
      ["t", "T"],
      ["r", "R"],
      ["c", "C"],
      [";", ":"]
    ],
    "row4": [
      ["/", "?"],
      ["z", "Z"],
      ["h", "H"],
      ["'", "\""],
      ["q", "Q"],
      ["v", "V"],
      ["p", "P"],
      ["m", "M"],
      ["j", "J"],
      [".", ">"]
    ],
    "row5": [[" "]]
  }
}
