{
  "keymapShowTopRow": false,
  "type": "ansi",
  "keys": {
    "row1": [
      ["`", "~"],
      ["1", "!"],
      ["2", "@"],
      ["3", "#"],
      ["4", "$"],
      ["5", "%"],
      ["6", "^"],
      ["7", "&"],
      ["8", "*"],
      ["9", "("],
      ["0", ")"],
      ["-", "_"],
      ["=", "+"]
    ],
    "row2": [
      ["p", "P"],
      ["l", "L"],
      ["d", "D"],
      ["w", "W"],
      ["g", "G"],
      ["j", "J"],
      ["x", "X"],
      ["o", "O"],
      ["y", "Y"],
      ["q", "Q"],
      ["[", "{"],
      ["]", "}"],
      ["\\", "|"]
    ],
    "row3": [
      ["n", "N"],
      ["r", "R"],
      ["s", "S"],
      ["t", "T"],
      ["m", "M"],
      ["u", "U"],
      ["a", "A"],
      ["e", "E"],
      ["i", "I"],
      ["h", "H"],
      ["'", "\""]
    ],
    "row4": [
      ["z", "Z"],
      ["c", "C"],
      ["f", "F"],
      ["v", "V"],
      ["b", "B"],
      [",", "<"],
      [".", ">"],
      ["?", "/"],
      [";", ":"],
      ["k", "K"]
    ],
    "row5": [[" "]]
  }
}
