{
  "keymapShowTopRow": false,
  "type": "ansi",
  "keys": {
    "row1": [
      ["`", "~"],
      ["1", "!"],
      ["2", "\""],
      ["3", "§"],
      ["4", "$"],
      ["5", "%"],
      ["6", "&"],
      ["7", "/"],
      ["8", "("],
      ["9", ")"],
      ["0", "="],
      ["ß", "?"],
      ["=", "+"]
    ],
    "row2": [
      ["q", "Q"],
      ["z", "Z"],
      ["o", "O"],
      ["p", "P"],
      ["y", "Y"],
      ["w", "W"],
      ["c", "C"],
      ["m", "M"],
      ["v", "V"],
      ["ß", "§"],
      ["[", "{"],
      ["]", "}"],
      ["\\", "|"]
    ],
    "row3": [
      ["h", "H"],
      ["a", "A"],
      ["e", "E"],
      ["i", "I"],
      ["u", "U"],
      ["d", "D"],
      ["t", "T"],
      ["n", "N"],
      ["s", "S"],
      ["r", "R"],
      ["'", "\""]
    ],
    "row4": [
      ["j", "J"],
      ["ö", "Ö"],
      ["ä", "Ä"],
      ["k", "K"],
      ["ü", "Ü"],
      ["b", "B"],
      ["g", "G"],
      ["l", "L"],
      ["f", "F"],
      ["x", "X"]
    ],
    "row5": [[" "]]
  }
}
