{
  "keymapShowTopRow": false,
  "type": "ansi",
  "keys": {
    "row1": [
      ["`", "~"],
      ["1", "!"],
      ["2", "@"],
      ["3", "#"],
      ["4", "$"],
      ["5", "%"],
      ["6", "^"],
      ["7", "&"],
      ["8", "*"],
      ["9", "("],
      ["0", ")"],
      ["-", "_"],
      ["=", "+"]
    ],
    "row2": [
      [",", "<"],
      ["w", "W"],
      ["l", "L"],
      ["m", "M"],
      ["k", "K"],
      [";", ":"],
      ["f", "F"],
      ["u", "U"],
      ["y", "Y"],
      ["q", "A"],
      ["\"", "{"],
      ["[", "]"],
      ["\\", "|"]
    ],
    "row3": [
      ["a", "A"],
      ["s", "S"],
      ["r", "R"],
      ["t", "T"],
      ["g", "G"],
      ["p", "P"],
      ["n", "N"],
      ["e", "E"],
      ["i", "I"],
      ["o", "O"],
      ["'", "}"]
    ],
    "row4": [
      ["z", "Z"],
      ["c", "C"],
      ["d", "D"],
      ["b", "B"],
      ["/", "?"],
      ["v", "V"],
      ["h", "H"],
      [".", ">"],
      ["j", "J"],
      ["x", "X"]
    ],
    "row5": [[" "]]
  }
}
