{
  "keymapShowTopRow": false,
  "type": "ansi",
  "keys": {
    "row1": [
      ["÷", "×"],
      ["1", "!"],
      ["2", "@"],
      ["3", "#"],
      ["4", "$"],
      ["5", "%"],
      ["6", "^"],
      ["7", "&"],
      ["8", "*"],
      ["9", ")"],
      ["0", "("],
      ["-", "_"],
      ["=", "+"]
    ],
    "row2": [
      ["ض", "ً"],
      ["ص", "ٌ"],
      ["ب", "ّ"],
      ["ح", "\\"],
      ["ل", "ۀ"],
      ["ت", "ـ"],
      ["م", "»"],
      ["ع", ","],
      ["غ", "؛"],
      ["ک", ":"],
      ["ج", "}"],
      ["چ", "{"],
      ["پ", "|"]
    ],
    "row3": [
      ["ش", "َ"],
      ["ق"],
      ["س", "ُ"],
      ["ف", "،"],
      ["ی", "ِ"],
      ["ا", "آ"],
      ["د", "أ"],
      ["ث", "ٍ"],
      ["ه", "]"],
      ["خ", "["],
      ["گ", "\""]
    ],
    "row4": [
      ["ظ", "ة"],
      ["ط", "ي"],
      ["ز", "ژ"],
      ["ر", "ؤ"],
      ["ذ", "إ"],
      ["ن", "«"],
      ["ئ", "ء"],
      ["و", "<"],
      [".", ">"],
      ["/", "؟"]
    ],
    "row5": [[" "]]
  }
}
