{
  "keymapShowTopRow": false,
  "type": "ansi",
  "keys": {
    "row1": [
      ["÷", "×"],
      ["1", "!"],
      ["2", "@"],
      ["3", "#"],
      ["4", "$"],
      ["5", "%"],
      ["6", "^"],
      ["7", "&"],
      ["8", "*"],
      ["9", ")"],
      ["0", "("],
      ["-", "_"],
      ["=", "+"]
    ],
    "row2": [
      ["ض", "ً"],
      ["ص", "ٌ"],
      ["ث", "ٍ"],
      ["ق"],
      ["ف", "،"],
      ["غ", "؛"],
      ["ع", ","],
      ["ه", "]"],
      ["خ", "["],
      ["ح", "\\"],
      ["ج", "}"],
      ["چ", "{"],
      ["پ", "|"]
    ],
    "row3": [
      ["ش", "َ"],
      ["س", "ُ"],
      ["ی", "ِ"],
      ["ب", "ّ"],
      ["ل", "ۀ"],
      ["ا", "آ"],
      ["ت", "ـ"],
      ["ن", "«"],
      ["م", "»"],
      ["ک", ":"],
      ["گ", "\""]
    ],
    "row4": [
      ["ظ", "ة"],
      ["ط", "ي"],
      ["ز", "ژ"],
      ["ر", "ؤ"],
      ["ذ", "إ"],
      ["د", "أ"],
      ["ئ", "ء"],
      ["و", "<"],
      [".", ">"],
      ["/", "؟"]
    ],
    "row5": [[" "]]
  }
}
