{
  "keymapShowTopRow": false,
  "type": "ansi",
  "keys": {
    "row1": [
      ["÷", "×"],
      ["1", "!"],
      ["@", "2"],
      ["3", "#"],
      ["4", "$"],
      ["5", "%"],
      ["6", "^"],
      ["7", "&"],
      ["8", "*"],
      ["9", ")"],
      ["0", "("],
      ["-", "_"],
      ["=", "+"]
    ],
    "row2": [
      ["ً", "ض"],
      ["ٌ", "ص"],
      ["ٍ", "ث"],
      ["ق", "ق"],
      ["،", "ف"],
      ["؛", "غ"],
      [",", "ع"],
      ["]", "ه"],
      ["[", "خ"],
      ["ح"],
      ["}", "ج"],
      ["{", "چ"],
      ["|", "پ"]
    ],
    "row3": [
      ["َ", "ش"],
      ["ُ", "س"],
      ["ِ", "ی"],
      ["ّ", "ب"],
      ["ۀ", "ل"],
      ["آ", "ا"],
      ["ـ", "ت"],
      ["«", "ن"],
      ["»", "م"],
      [":", "ک"],
      ["گ", "\""]
    ],
    "row4": [
      ["ة", "ظ"],
      ["ي", "ط"],
      ["ژ", "ز"],
      ["ؤ", "ر"],
      ["إ", "ذ"],
      ["أ", "د"],
      ["ء", "ئ"],
      ["<", "و"],
      [">", "."],
      ["/", "؟"]
    ],
    "row5": [[" "]]
  }
}
