{
  "keymapShowTopRow": true,
  "type": "ansi",
  "keys": {
    "row1": [
      ["`", "~"],
      ["۱", "!"],
      ["۲", "٬"],
      ["۳", "٫"],
      ["۴"],
      ["۵", "٪"],
      ["۶", "×"],
      ["۷", "،"],
      ["۸", "*"],
      ["۹", ")"],
      ["۰", "("],
      ["-", "ـ"],
      ["=", "+"]
    ],
    "row2": [
      ["ض", "ْ"],
      ["ص", "ٌ"],
      ["ث", "ٍ"],
      ["ق", "ً"],
      ["ف", "ُ"],
      ["غ", "ِ"],
      ["ع", "َ"],
      ["ه", "ّ"],
      ["خ", "]"],
      ["ح", "["],
      ["ج", "}"],
      ["چ", "}"],
      ["\\", "{"]
    ],
    "row3": [
      ["ش", "ؤ"],
      ["س", "ئ"],
      ["ی", "ي"],
      ["ب", "إ"],
      ["ل", "أ"],
      ["ا", "آ"],
      ["ت", "ة"],
      ["ن", "»"],
      ["م", "«"],
      ["ک", ":"],
      ["گ", "؛"]
    ],
    "row4": [
      ["ظ", "ك"],
      ["ط", "ط"],
      ["ز", "ژ"],
      ["ر", "ٰ"],
      ["ذ"],
      ["د", "ٔ"],
      ["پ", "ء"],
      ["و", ">"],
      [".", "<"],
      ["/", "?"]
    ],
    "row5": [[" "]]
  }
}
