{
  "keymapShowTopRow": true,
  "type": "ansi",
  "keys": {
    "row1": [
      ["گ", "؛"],
      ["۱", "!"],
      ["۲", "٬"],
      ["۳", "٫"],
      ["۴"],
      ["۵", "٪"],
      ["۶", "×"],
      ["۷", "،"],
      ["۸", "*"],
      ["۹", ")"],
      ["۰", ")"],
      ["-", "ـ"],
      ["=", "+"]
    ],
    "row2": [
      ["ض", "ْ"],
      ["ص", "ٌ"],
      ["ب", "إ"],
      ["ح", "["],
      ["ل", "أ"],
      ["ت", "ة"],
      ["م", "«"],
      ["ع", "َ"],
      ["غ", "ِ"],
      ["ک", ":"],
      ["\\", "|"],
      ["ج", "}"],
      ["چ", "{"]
    ],
    "row3": [
      ["ش", "ؤ"],
      ["ق", "ً"],
      ["س", "ئ"],
      ["ف", "ُ"],
      ["ی", "ي"],
      ["ا", "آ"],
      ["د", "ٔ"],
      ["ث", "ٍ"],
      ["ه", "ّ"],
      ["خ", "]"],
      ["گ", "؛"]
    ],
    "row4": [
      ["ظ", "ك"],
      ["ط", "ط"],
      ["ز", "ژ"],
      ["ر", "ٰ"],
      ["ذ", "‌"],
      ["ن", "»"],
      ["پ", "ء"],
      ["و", ">"],
      [".", "<"],
      ["/", "؟"]
    ],
    "row5": [[" "]]
  }
}
