{
  "keymapShowTopRow": false,
  "type": "ansi",
  "keys": {
    "row1": [
      ["`", "~"],
      ["1", "!"],
      ["2", "@"],
      ["3", "#"],
      ["4", "$"],
      ["5", "%"],
      ["6", "^"],
      ["7", "&"],
      ["8", "*"],
      ["9", "("],
      ["0", ")"],
      ["-", "_"],
      ["=", "+"]
    ],
    "row2": [
      ["y", "Y"],
      ["l", "L"],
      ["r", "R"],
      ["d", "D"],
      ["w", "W"],
      ["j", "J"],
      ["m", "M"],
      ["o", "O"],
      ["u", "U"],
      [",", "<"],
      ["[", "{"],
      ["]", "}"],
      ["\\", "|"]
    ],
    "row3": [
      ["c", "C"],
      ["s", "S"],
      ["n", "N"],
      ["t", "T"],
      ["g", "G"],
      ["p", "P"],
      ["h", "H"],
      ["a", "A"],
      ["e", "E"],
      ["i", "I"],
      [";", ":"]
    ],
    "row4": [
      ["x", "X"],
      ["z", "Z"],
      ["q", "Q"],
      ["v", "V"],
      ["k", "K"],
      ["b", "B"],
      ["f", "F"],
      ["'", "\""],
      ["/", "?"],
      [".", ">"]
    ],
    "row5": [[" "]]
  }
}
