{
  "keymapShowTopRow": false,
  "type": "ansi",
  "keys": {
    "row1": [
      ["`", "~"],
      ["1", "!"],
      ["2", "@"],
      ["3", "#"],
      ["4", "$"],
      ["5", "%"],
      ["6", "^"],
      ["7", "&"],
      ["8", "*"],
      ["9", "("],
      ["0", ")"],
      ["-", "_"],
      ["=", "+"]
    ],
    "row2": [
      ["q", "Q"],
      ["l", "L"],
      ["c", "C"],
      ["m", "M"],
      ["K", "K"],
      ["'", "\""],
      ["f", "F"],
      ["u", "U"],
      ["o", "O"],
      ["y", "Y"],
      ["[", "{"],
      ["]", "}"],
      ["\\", "|"]
    ],
    "row3": [
      ["n", "N"],
      ["r", "R"],
      ["s", "S"],
      ["t", "T"],
      ["w", "W"],
      ["p", "P"],
      ["h", "H"],
      ["e", "E"],
      ["a", "A"],
      ["i", "I"],
      ["/", "?"]
    ],
    "row4": [
      ["j", "J"],
      ["x", "X"],
      ["z", "Z"],
      ["g", "G"],
      ["v", "V"],
      ["b", "B"],
      ["d", "D"],
      [";", ":"],
      [",", "<"],
      [".", ">"]
    ],
    "row5": [[" "]]
  }
}
