{
  "keymapShowTopRow": true,
  "type": "ansi",
  "keys": {
    "row1": [
      ["$", "~"],
      ["&", "%"],
      ["[", "7"],
      ["{", "5"],
      ["}", "3"],
      ["(", "1"],
      ["=", "9"],
      ["*", "0"],
      [")", "2"],
      ["+", "4"],
      ["]", "6"],
      ["!", "8"],
      ["#", "`"]
    ],
    "row2": [
      [";", ":"],
      [",", "<"],
      [".", ">"],
      ["p", "P"],
      ["y", "Y"],
      ["f", "F"],
      ["g", "G"],
      ["c", "C"],
      ["r", "R"],
      ["l", "L"],
      ["/", "?"],
      ["@", "^"],
      ["\\", "|"]
    ],
    "row3": [
      ["a", "A"],
      ["o", "O"],
      ["e", "E"],
      ["u", "U"],
      ["i", "I"],
      ["d", "D"],
      ["h", "H"],
      ["t", "T"],
      ["n", "N"],
      ["s", "S"],
      ["-", "_"]
    ],
    "row4": [
      ["'", "\""],
      ["q", "Q"],
      ["j", "J"],
      ["k", "K"],
      ["x", "X"],
      ["b", "B"],
      ["m", "M"],
      ["w", "W"],
      ["v", "V"],
      ["z", "Z"]
    ],
    "row5": [[" "]]
  }
}
