{
  "keymapShowTopRow": false,
  "type": "ansi",
  "keys": {
    "row1": [
      ["`", "~"],
      ["1", "!"],
      ["2", "@"],
      ["3", "#"],
      ["4", "$"],
      ["5", "%"],
      ["6", "^"],
      ["7", "&"],
      ["8", "*"],
      ["9", "("],
      ["0", ")"],
      ["-", "_"],
      ["=", "+"]
    ],
    "row2": [
      ["`", "~"],
      ["w", "W"],
      ["c", "C"],
      ["d", "D"],
      ["f", "F"],
      ["q", "Q"],
      ["l", "L"],
      ["u", "U"],
      ["y", "Y"],
      [";", ":"],
      ["[", "{"],
      ["]", "}"],
      ["\\", "|"]
    ],
    "row3": [
      ["p", "P"],
      ["r", "R"],
      ["s", "S"],
      ["t", "T"],
      ["g", "G"],
      ["m", "M"],
      ["n", "N"],
      ["a", "A"],
      ["i", "I"],
      ["o", "O"],
      ["'", "\""]
    ],
    "row4": [
      ["x", "X"],
      ["h", "H"],
      ["v", "V"],
      ["b", "B"],
      ["[", "{"],
      [",", "<"],
      ["j", "J"],
      ["k", "K"],
      ["z", "Z"],
      [".", ">"]
    ],
    "row5": [[" "], ["e", "E"]]
  }
}
