{
  "keymapShowTopRow": false,
  "type": "ansi",
  "keys": {
    "row1": [
      ["`", "~"],
      ["1", "!"],
      ["2", "@"],
      ["3", "#"],
      ["4", "$"],
      ["5", "%"],
      ["6", "^"],
      ["7", "&"],
      ["8", "*"],
      ["9", "("],
      ["0", ")"],
      ["-", "_"],
      ["=", "+"]
    ],
    "row2": [
      ["q", "Q"],
      ["g", "G"],
      ["m", "M"],
      ["l", "L"],
      ["w", "W"],
      ["b", "B"],
      ["y", "Y"],
      ["u", "U"],
      ["v", "V"],
      [";", ":"],
      ["[", "{"],
      ["]", "}"],
      ["\\", "|"]
    ],
    "row3": [
      ["d", "D"],
      ["s", "S"],
      ["t", "T"],
      ["n", "N"],
      ["r", "R"],
      ["i", "I"],
      ["a", "A"],
      ["e", "E"],
      ["o", "O"],
      ["h", "H"],
      ["'", "\""]
    ],
    "row4": [
      ["z", "Z"],
      ["x", "X"],
      ["c", "C"],
      ["f", "F"],
      ["j", "J"],
      ["k", "K"],
      ["p", "P"],
      [",", "<"],
      [".", ">"],
      ["/", "?"]
    ],
    "row5": [[" "]]
  }
}
