{
  "keymapShowTopRow": true,
  "type": "ansi",
  "keys": {
    "row1": [
      ["`", "~"],
      ["1", "!"],
      ["2", "@"],
      ["3", "#"],
      ["4", "$"],
      ["5", "%"],
      ["=", "+"],
      ["6", "^"],
      ["7", "&"],
      ["8", "*"],
      ["9", "("],
      ["0", ")"],
      ["-", "_"]
    ],
    "row2": [
      ["q", "Q"],
      ["u", "U"],
      ["a", "A"],
      ["r", "R"],
      ["t", "T"],
      ["z", "Z"],
      ["/", "?"],
      ["g", "G"],
      ["l", "L"],
      ["y", "Y"],
      ["p", "P"],
      ["h", "H"],
      ["\\", "|"]
    ],
    "row3": [
      ["[", "{"],
      ["j", "J"],
      ["o", "O"],
      ["b", "B"],
      ["]", "}"],
      [";", ":"],
      ["v", "V"],
      ["e", "E"],
      ["x", "X"],
      ["'", "\""],
      ["d", "D"]
    ],
    "row4": [
      ["c", "C"],
      ["w", "W"],
      ["m", "M"],
      [",", "<"],
      ["f", "F"],
      ["i", "I"],
      ["n", "N"],
      ["k", "K"],
      ["s", "S"],
      [".", ">"]
    ],
    "row5": [[" "]]
  }
}
