{
  "keymapShowTopRow": false,
  "type": "ansi",
  "keys": {
    "row1": [
      ["`", "~"],
      ["1", "!"],
      ["2", "@"],
      ["3", "#"],
      ["4", "$"],
      ["5", "%"],
      ["6", "^"],
      ["7", "&"],
      ["8", "*"],
      ["9", "("],
      ["0", ")"],
      ["-", "_"],
      ["=", "+"]
    ],
    "row2": [
      ["f", "F"],
      ["d", "D"],
      ["l", "L"],
      ["g", "G"],
      ["v", "V"],
      ["q", "Q"],
      ["r", "R"],
      ["u", "U"],
      ["o", "O"],
      [",", "<"],
      ["[", "{"],
      ["]", "}"],
      ["\\", "|"]
    ],
    "row3": [
      ["s", "S"],
      ["t", "T"],
      ["h", "H"],
      ["c", "C"],
      ["y", "Y"],
      ["j", "J"],
      ["n", "N"],
      ["e", "E"],
      ["a", "A"],
      ["i", "I"],
      ["/", "?"]
    ],
    "row4": [
      ["z", "Z"],
      ["k", "K"],
      ["m", "M"],
      ["p", "P"],
      ["w", "W"],
      ["x", "X"],
      ["b", "B"],
      [";", ":"],
      ["'", "\""],
      [".", ">"]
    ],
    "row5": [[" "]]
  }
}
