{
  "keymapShowTopRow": true,
  "type": "ansi",
  "keys": {
    "row1": [
      ["`", "~"],
      ["1", "!"],
      ["2", "@"],
      ["3", "#"],
      ["4", "$"],
      ["5", "%"],
      ["6", "^"],
      ["7", "&"],
      ["8", "*"],
      ["9", "("],
      ["0", ")"],
      ["[", "{"],
      ["]", "}"]
    ],
    "row2": [
      ["y", "Y"],
      ["l", "L"],
      ["u", "U"],
      ["o", "O"],
      [".", ">"],
      ["z", "Z"],
      ["f", "F"],
      ["h", "H"],
      ["c", "C"],
      ["w", "W"],
      ["/", "?"],
      ["=", "+"],
      ["\\", "|"]
    ],
    "row3": [
      ["i", "I"],
      ["r", "R"],
      ["e", "E"],
      ["a", "A"],
      [",", "<"],
      ["d", "D"],
      ["t", "T"],
      ["n", "N"],
      ["s", "S"],
      ["m", "M"],
      ["-", "_"]
    ],
    "row4": [
      [";", ":"],
      ["j", "J"],
      ["'", "\""],
      ["q", "Q"],
      ["x", "X"],
      ["p", "P"],
      ["k", "K"],
      ["b", "B"],
      ["g", "G"],
      ["v", "V"]
    ],
    "row5": [[" "]]
  }
}
