{
  "keymapShowTopRow": false,
  "type": "ansi",
  "keys": {
    "row1": [
      ["`", "~"],
      ["1", "!"],
      ["2", "@"],
      ["3", "#"],
      ["4", "$"],
      ["5", "%"],
      ["6", "^"],
      ["7", "&"],
      ["8", "*"],
      ["9", "("],
      ["0", ")"],
      ["-", "_"],
      ["=", "+"]
    ],
    "row2": [
      ["f", "F"],
      ["r", "R"],
      ["d", "D"],
      ["p", "P"],
      ["v", "V"],
      ["q", "Q"],
      ["j", "J"],
      ["u", "U"],
      ["o", "O"],
      ["y", "Y"],
      ["[", "{"],
      ["]", "}"],
      ["\\", "|"]
    ],
    "row3": [
      ["s", "S"],
      ["n", "N"],
      ["t", "T"],
      ["c", "C"],
      ["b", "B"],
      [".", ">"],
      ["h", "H"],
      ["e", "E"],
      ["a", "A"],
      ["i", "I"],
      ["/", "?"]
    ],
    "row4": [
      ["z", "Z"],
      ["x", "X"],
      ["k", "K"],
      ["g", "G"],
      ["w", "W"],
      ["m", "M"],
      ["l", "L"],
      [";", ":"],
      ["'", "\""],
      [",", "<"]
    ],
    "row5": [[" "]]
  }
}
