{
  "keymapShowTopRow": true,
  "type": "ansi",
  "keys": {
    "row1": [
      ["ё", "Ё"],
      ["1", "№"],
      ["2", ":"],
      ["3", ";"],
      ["4", "/"],
      ["5", "₽"],
      ["6", "@"],
      ["7", "ё"],
      ["8", "?"],
      ["9", "!"],
      ["0", "%"],
      ["Ъ", "Ь"],
      ["=", "+"]
    ],
    "row2": [
      ["ц", "Ц"],
      ["ы", "Ы"],
      ["я", "Я"],
      ["й", "Й"],
      ["ь", "ъ"],
      ["з", "З"],
      ["д", "Д"],
      ["в", "В"],
      ["к", "К"],
      ["г", "Г"],
      ["ш", "Ш"],
      ["щ", "Щ"],
      ["\\", "/"]
    ],
    "row3": [
      ["у", "У"],
      ["и", "И"],
      ["о", "О"],
      ["е", "Е"],
      ["а", "А"],
      ["л", "Л"],
      ["р", "Р"],
      ["т", "Т"],
      ["н", "Н"],
      ["с", "С"],
      ["х", "Х"]
    ],
    "row4": [
      ["ф", "Ф"],
      ["ю", "Ю"],
      ["э", "Э"],
      [",", "-"],
      [".", "\""],
      ["ч", "Ч"],
      ["м", "М"],
      ["п", "П"],
      ["б", "Б"],
      ["ж", "Ж"]
    ],
    "row5": [[" "]]
  }
}
