{
  "keymapShowTopRow": false,
  "type": "ansi",
  "keys": {
    "row1": [
      ["`", "~"],
      ["1", "!"],
      ["2", "@"],
      ["3", "#"],
      ["4", "$"],
      ["5", "%"],
      ["6", "^"],
      ["7", "&"],
      ["8", "*"],
      ["9", "("],
      ["0", ")"],
      ["-", "_"],
      ["=", "+"]
    ],
    "row2": [
      ["y", "Y"],
      ["o", "O"],
      ["u", "U"],
      ["b", "B"],
      [".", ">"],
      ["x", "X"],
      ["k", "K"],
      ["c", "C"],
      ["l", "L"],
      ["v", "V"],
      ["[", "{"],
      ["]", "}"],
      ["\\", "|"]
    ],
    "row3": [
      ["i", "I"],
      ["a", "A"],
      ["e", "E"],
      ["n", "N"],
      [",", "<"],
      ["m", "M"],
      ["h", "H"],
      ["s", "S"],
      ["r", "R"],
      ["t", "T"],
      [";", ":"]
    ],
    "row4": [
      ["'", "\""],
      ["/", "?"],
      ["p", "P"],
      ["w", "W"],
      ["z", "Z"],
      ["f", "F"],
      ["d", "D"],
      ["g", "G"],
      ["j", "J"],
      ["q", "Q"]
    ],
    "row5": [[" "]]
  }
}
