{
  "keymapShowTopRow": false,
  "type": "ansi",
  "keys": {
    "row1": [
      ["`", "~"],
      ["1", "!"],
      ["2", "@"],
      ["3", "#"],
      ["4", "$"],
      ["5", "%"],
      ["6", "^"],
      ["7", "&"],
      ["8", "*"],
      ["9", "("],
      ["0", ")"],
      ["-", "_"],
      ["=", "+"]
    ],
    "row2": [
      ["y", "Y"],
      ["o", "O"],
      ["u", "U"],
      ["w", "W"],
      ["b", "B"],
      ["x", "X"],
      ["k", "K"],
      ["c", "C"],
      ["l", "L"],
      ["v", "V"],
      ["[", "{"],
      ["]", "}"],
      ["\\", "|"]
    ],
    "row3": [
      ["i", "I"],
      ["a", "A"],
      ["e", "E"],
      ["n", "N"],
      ["p", "P"],
      ["d", "D"],
      ["h", "H"],
      ["s", "S"],
      ["r", "R"],
      ["t", "T"],
      ["'", "\""]
    ],
    "row4": [
      ["j", "J"],
      ["/", "?"],
      [",", "<"],
      [".", ">"],
      ["q", "Q"],
      ["f", "F"],
      ["m", "M"],
      ["g", "G"],
      ["'", "\""],
      ["z", "Z"]
    ],
    "row5": [[" "]]
  }
}
