{
  "keymapShowTopRow": false,
  "type": "ansi",
  "keys": {
    "row1": [
      ["`", "~"],
      ["1", "!"],
      ["2", "@"],
      ["3", "#"],
      ["4", "$"],
      ["5", "%"],
      ["6", "^"],
      ["7", "&"],
      ["8", "*"],
      ["9", "("],
      ["0", ")"],
      ["-", "_"],
      ["=", "+"]
    ],
    "row2": [
      ["q", "Q"],
      ["b", "B"],
      ["m", "M"],
      ["g", "G"],
      ["k", "K"],
      ["x", "X"],
      ["l", "L"],
      ["o", "O"],
      ["u", "U"],
      [";", ":"],
      ["[", "{"],
      ["]", "}"],
      ["\\", "|"]
    ],
    "row3": [
      ["d", "D"],
      ["n", "N"],
      ["s", "S"],
      ["t", "T"],
      ["w", "W"],
      ["z", "Z"],
      ["r", "R"],
      ["a", "A"],
      ["e", "E"],
      ["i", "I"],
      ["'", "\""]
    ],
    "row4": [
      ["y", "Y"],
      ["f", "F"],
      ["c", "C"],
      ["p", "P"],
      ["v", "V"],
      ["j", "J"],
      ["h", "H"],
      [",", "<"],
      [".", ">"],
      ["/", "?"]
    ],
    "row5": [[" "]]
  }
}
