{
  "keymapShowTopRow": false,
  "type": "ansi",
  "keys": {
    "row1": [
      ["`", "~"],
      ["1", "!"],
      ["2", "@"],
      ["3", "#"],
      ["4", "$"],
      ["5", "%"],
      ["6", "^"],
      ["7", "&"],
      ["8", "*"],
      ["9", "("],
      ["0", ")"],
      ["-", "_"],
      ["=", "+"]
    ],
    "row2": [
      ["j", "J"],
      ["c", "C"],
      ["y", "Y"],
      ["f", "F"],
      ["k", "K"],
      ["z", "Z"],
      ["l", "L"],
      [",", "<"],
      ["u", "U"],
      ["q", "Q"],
      ["[", "{"],
      ["]", "}"],
      ["\\", "|"]
    ],
    "row3": [
      ["r", "R"],
      ["s", "S"],
      ["t", "T"],
      ["h", "H"],
      ["d", "D"],
      ["m", "M"],
      ["n", "N"],
      ["a", "A"],
      ["i", "I"],
      ["o", "O"],
      ["'", "\""]
    ],
    "row4": [
      ["/", "?"],
      ["v", "V"],
      ["g", "G"],
      ["p", "P"],
      ["b", "B"],
      ["x", "X"],
      ["w", "W"],
      [".", ">"],
      [";", ":"],
      ["-", "_"]
    ],
    "row5": [["e", "E"], [" "]]
  }
}
