{
  "keymapShowTopRow": false,
  "type": "ansi",
  "keys": {
    "row1": [
      ["ё", "Ё"],
      ["1", "!"],
      ["2", "\""],
      ["3", "№", "#", "³"],
      ["4", ";", "$", "£"],
      ["5", "%", "€", "%"],
      ["6", ":"],
      ["7", "?", "&"],
      ["8", "*", "₽", "₴"],
      ["9", "(", "[", "{"],
      ["0", ")", "]", "}"],
      ["-", "_", "–", "—"],
      ["=", "+", "×", "÷"]
    ],
    "row2": [
      ["я", "Я", "ѣ", "Ѣ"],
      ["ж", "Ж", "ѵ", "Ѵ"],
      ["ф", "Ф", "ѳ", "Ѳ"],
      ["п", "П", "п", "П"],
      ["г", "Г", "ґ", "Ґ"],
      ["й", "Й", "ј", "Ј"],
      ["л", "Л", "љ", "Љ"],
      ["у", "У", "ў", "Ў"],
      ["ы", "Ы", "ї", "Ї"],
      ["ю", "Ю", ";", ":"],
      ["ш", "Ш", "«", "„"],
      ["щ", "Щ", "»", "“"],
      ["э", "Э", "’", "”"]
    ],
    "row3": [
      ["а", "А", "'", "ʼ"],
      ["р", "Р", "®"],
      ["с", "С", "@"],
      ["т", "Т", "ћ", "Ћ"],
      ["д", "Д", "ђ", "Ђ"],
      ["ч", "Ч", "џ", "Џ"],
      ["н", "Н", "њ", "Њ"],
      ["е", "Е", "є", "Є"],
      ["и", "И", "і", "І"],
      ["о", "О", "о", "О"],
      ["ь", "Ь", "ъ", "Ъ"]
    ],
    "row4": [
      ["з", "З", "ѕ", "Ѕ"],
      ["х", "Х", "х", "Х"],
      ["ц", "Ц", "©"],
      ["в", "В", "в", "В"],
      ["б", "Б", "ѓ", "Ѓ"],
      ["к", "К", "ќ", "Ќ"],
      ["м", "М", "м", "М"],
      [",", ";", "<"],
      [".", ":", ">"],
      ["/", "?", "\\", "|"]
    ],
    "row5": [[" "]]
  }
}
