{
  "keymapShowTopRow": false,
  "type": "ansi",
  "keys": {
    "row1": [
      ["`", "~"],
      ["1", "!"],
      ["2", "@"],
      ["3", "#"],
      ["4", "$"],
      ["5", "%"],
      ["6", "^"],
      ["7", "&"],
      ["8", "*"],
      ["9", "("],
      ["0", ")"],
      ["-", "_"],
      ["=", "+"]
    ],
    "row2": [
      ["b", "B"],
      ["u", "U"],
      ["a", "A"],
      ["r", "R"],
      ["j", "J"],
      ["g", "G"],
      ["w", "W"],
      ["d", "D"],
      ["y", "Y"],
      ["'", "\""],
      ["[", "{"],
      ["]", "}"],
      ["\\", "|"]
    ],
    "row3": [
      ["s", "S"],
      ["i", "I"],
      ["o", "O"],
      ["n", "N"],
      ["l", "L"],
      ["c", "C"],
      ["m", "M"],
      ["t", "T"],
      ["h", "H"],
      ["e", "E"],
      [";", ":"]
    ],
    "row4": [
      ["q", "Q"],
      [",", "<"],
      [".", ">"],
      ["x", "X"],
      ["z", "Z"],
      ["v", "V"],
      ["f", "F"],
      ["p", "P"],
      ["k", "K"],
      ["/", "?"]
    ],
    "row5": [[" "]]
  }
}
