{
  "keymapShowTopRow": false,
  "type": "ansi",
  "keys": {
    "row1": [
      ["`", "~"],
      ["1", "!"],
      ["2", "@"],
      ["3", "#"],
      ["4", "$"],
      ["5", "%"],
      ["6", "^"],
      ["7", "&"],
      ["8", "*"],
      ["9", "("],
      ["0", ")"],
      ["-", "_"],
      ["=", "+"]
    ],
    "row2": [
      ["f", "F"],
      ["u", "U"],
      ["l", "L"],
      ["v", "V"],
      ["b", "B"],
      ["q", "Q"],
      ["g", "G"],
      ["n", "N"],
      ["o", "O"],
      ["j", "J"],
      ["[", "{"],
      ["]", "}"],
      ["\\", "|"]
    ],
    "row3": [
      ["s", "S"],
      ["e", "E"],
      ["h", "H"],
      ["t", "T"],
      ["k", "K"],
      ["'", "\""],
      ["d", "D"],
      ["r", "R"],
      ["a", "A"],
      ["i", "I"],
      [".", ">"]
    ],
    "row4": [
      [";", ":"],
      ["m", "M"],
      ["p", "P"],
      ["w", "W"],
      ["z", "Z"],
      ["y", "Y"],
      ["c", "C"],
      ["x", "X"],
      ["/", "?"],
      [",", "<"]
    ],
    "row5": [[" "]]
  }
}
