{
  "keymapShowTopRow": false,
  "type": "ansi",
  "keys": {
    "row1": [
      ["`", "~"],
      ["1", "!"],
      ["2", "@"],
      ["3", "#"],
      ["4", "$"],
      ["5", "%"],
      ["6", "^"],
      ["7", "&"],
      ["8", "*"],
      ["9", "("],
      ["0", ")"],
      ["-", "_"],
      ["=", "+"]
    ],
    "row2": [
      ["f", "F"],
      ["l", "L"],
      ["h", "H"],
      ["v", "V"],
      ["z", "Z"],
      ["q", "Q"],
      ["w", "W"],
      ["u", "U"],
      ["o", "O"],
      ["y", "Y"],
      ["[", "{"],
      ["]", "}"],
      ["\\", "|"]
    ],
    "row3": [
      ["s", "S"],
      ["r", "R"],
      ["n", "N"],
      ["t", "T"],
      ["k", "K"],
      ["c", "C"],
      ["d", "D"],
      ["e", "E"],
      ["a", "A"],
      ["i", "I"],
      [";", ":"]
    ],
    "row4": [
      ["x", "X"],
      ["'", "\""],
      ["b", "B"],
      ["m", "M"],
      ["j", "J"],
      ["p", "P"],
      ["g", "G"],
      [",", "<"],
      [".", ">"],
      ["/", "?"]
    ],
    "row5": [[" "]]
  }
}
