{
  "keymapShowTopRow": false,
  "type": "ansi",
  "keys": {
    "row1": [
      ["`", "~"],
      ["1", "!"],
      ["2", "@"],
      ["3", "#"],
      ["4", "$"],
      ["5", "%"],
      ["6", "^"],
      ["7", "&"],
      ["8", "*"],
      ["9", "("],
      ["0", ")"],
      ["-", "_"],
      ["=", "+"]
    ],
    "row2": [
      ["x", "X"],
      ["l", "L"],
      ["d", "D"],
      ["k", "K"],
      ["v", "V"],
      ["z", "Z"],
      ["w", "W"],
      ["o", "O"],
      ["u", "U"],
      [";", ":"],
      ["[", "{"],
      ["]", "}"],
      ["\\", "|"]
    ],
    "row3": [
      ["s", "S"],
      ["r", "R"],
      ["t", "T"],
      ["n", "N"],
      ["f", "F"],
      ["g", "G"],
      ["y", "Y"],
      ["e", "E"],
      ["i", "I"],
      ["a", "A"],
      ["/", "?"]
    ],
    "row4": [
      ["q", "Q"],
      ["j", "J"],
      ["m", "M"],
      ["h", "H"],
      ["b", "B"],
      ["p", "P"],
      ["c", "C"],
      ["'", "\""],
      [",", "<"],
      [".", ">"]
    ],
    "row5": [[" "]]
  }
}
