{
  "keymapShowTopRow": false,
  "type": "ansi",
  "keys": {
    "row1": [
      ["`", "~"],
      ["1", "!"],
      ["2", "@"],
      ["3", "#"],
      ["4", "$"],
      ["5", "%"],
      ["6", "^"],
      ["7", "&"],
      ["8", "*"],
      ["9", "("],
      ["0", ")"],
      ["-", "_"],
      ["=", "+"]
    ],
    "row2": [
      [",", "<"],
      ["a", "A"],
      ["y", "Y"],
      ["c", "C"],
      ["v", "V"],
      ["q", "Q"],
      ["d", "D"],
      ["l", "L"],
      ["u", "U"],
      ["x", "X"],
      ["[", "{"],
      ["]", "}"],
      ["\\", "|"]
    ],
    "row3": [
      ["i", "I"],
      ["o", "O"],
      ["n", "N"],
      ["s", "S"],
      ["b", "B"],
      ["p", "P"],
      ["t", "T"],
      ["h", "H"],
      ["e", "E"],
      ["r", "R"],
      [";", ":"]
    ],
    "row4": [
      [".", ">"],
      ["'", "\""],
      ["f", "F"],
      ["g", "G"],
      ["j", "J"],
      ["k", "K"],
      ["w", "W"],
      ["m", "M"],
      [";", ":"],
      ["z", "Z"]
    ],
    "row5": [[" "]]
  }
}
