{
  "keymapShowTopRow": false,
  "type": "iso",
  "keys": {
    "row1": [
      ["º", "ª"],
      ["1", "!"],
      ["2", "\""],
      ["3", "·"],
      ["4", "$"],
      ["5", "%"],
      ["6", "&"],
      ["7", "/"],
      ["8", "("],
      ["9", ")"],
      ["0", "="],
      ["'", "?"],
      ["¡", "¿"]
    ],
    "row2": [
      [".", ":"],
      [",", ";"],
      ["ñ", "Ñ"],
      ["p", "P"],
      ["y", "Y"],
      ["f", "F"],
      ["g", "G"],
      ["c", "C"],
      ["h", "H"],
      ["l", "L"],
      ["`", "^"],
      ["+", "*"]
    ],
    "row3": [
      ["a", "A"],
      ["o", "O"],
      ["e", "E"],
      ["u", "U"],
      ["i", "I"],
      ["d", "D"],
      ["r", "R"],
      ["t", "T"],
      ["n", "N"],
      ["s", "S"],
      ["´", "¨"],
      ["ç", "Ç"]
    ],
    "row4": [
      ["<", ">"],
      ["-", "_"],
      ["q", "Q"],
      ["j", "J"],
      ["k", "K"],
      ["x", "X"],
      ["b", "B"],
      ["m", "M"],
      ["w", "W"],
      ["v", "V"],
      ["z", "Z"]
    ],
    "row5": [[" "]]
  }
}
