{
  "keymapShowTopRow": false,
  "type": "ansi",
  "keys": {
    "row1": [
      ["\"", "'"],
      ["1", "!"],
      ["2", "@"],
      ["3", "#"],
      ["4", "$"],
      ["5", "%"],
      ["6", "^"],
      ["7", "&"],
      ["8", "*"],
      ["9", "("],
      ["0", ")"],
      ["-", "_"],
      ["=", "+"]
    ],
    "row2": [
      ["ь", "Ь", "ъ", "Ъ"],
      ["у", "У"],
      ["а", "А"],
      ["ж", "Ж"],
      ["ю", "Ю"],
      ["г", "Г"],
      ["б", "Б"],
      ["р", "Р"],
      ["л", "Л"],
      ["х", "Х"],
      [",", ";"],
      [".", ":"],
      ["\\", "|"]
    ],
    "row3": [
      ["и", "И"],
      ["е", "Е", "ё", "Ё"],
      ["о", "О"],
      ["к", "К"],
      ["я", "Я"],
      ["м", "М"],
      ["т", "Т"],
      ["с", "С"],
      ["н", "Н"],
      ["з", "З"],
      [".", ":"]
    ],
    "row4": [
      ["ф", "Ф"],
      ["э", "Э"],
      ["ы", "Ы"],
      ["п", "П"],
      ["й", "Й"],
      ["д", "Д"],
      ["в", "В"],
      ["ч", "Ч"],
      ["ш", "Ш", "щ", "Щ"],
      ["ц", "Ц"]
    ],
    "row5": [[" "]]
  }
}
