{
  "keymapShowTopRow": true,
  "type": "ansi",
  "keys": {
    "row1": [
      ["`", "~"],
      ["1", "!"],
      ["2", "@"],
      ["3", "#"],
      ["4", "$"],
      ["5", "%"],
      ["6", "^"],
      ["7", "&"],
      ["8", "*"],
      ["9", "{"],
      ["0", "}"],
      ["(", "["],
      [")", "]"]
    ],
    "row2": [
      ["v", "V"],
      ["m", "M"],
      ["h", "H"],
      ["g", "G"],
      ["p", "P"],
      ["x", "X"],
      ["l", "L"],
      ["o", "O"],
      ["u", "U"],
      ["y", "Y"],
      ["j", "J"],
      ["=", "+"],
      ["\\", "|"]
    ],
    "row3": [
      ["s", "S"],
      ["t", "T"],
      ["n", "N"],
      ["d", "D"],
      ["c", "C"],
      ["w", "W"],
      ["r", "R"],
      ["a", "A"],
      ["e", "E"],
      ["i", "I"],
      ["-", "_"]
    ],
    "row4": [
      ["z", "Z"],
      ["k", "K"],
      ["b", "B"],
      ["f", "F"],
      ["q", "Q"],
      [",", ";"],
      [".", ":"],
      ["'", "<"],
      ["\"", ">"],
      ["?", "!"]
    ],
    "row5": [[" "]]
  }
}
