{
  "keymapShowTopRow": false,
  "type": "iso",
  "keys": {
    "row1": [
      ["`", "~"],
      ["1", "!"],
      ["2", "@"],
      ["3", "#"],
      ["4", "$"],
      ["5", "%"],
      ["6", "^"],
      ["7", "&"],
      ["8", "*"],
      ["9", "<"],
      ["0", ">"],
      ["-", "_"],
      ["=", "+"]
    ],
    "row2": [
      ["v", "V"],
      ["m", "M"],
      ["l", "L"],
      ["c", "C"],
      ["p", "P"],
      ["x", "X"],
      ["f", "F"],
      ["o", "O"],
      ["u", "U"],
      ["j", "J"],
      ["[", "{"],
      ["]", "}"]
    ],
    "row3": [
      ["s", "S"],
      ["t", "T"],
      ["r", "R"],
      ["d", "D"],
      ["y", "Y"],
      [".", "("],
      ["n", "N"],
      ["a", "A"],
      ["e", "E"],
      ["i", "I"],
      ["/", "?"],
      ["\\", "|"]
    ],
    "row4": [
      ["z", "Z"],
      ["k", "K"],
      ["q", "Q"],
      ["g", "G"],
      ["w", "W"],
      ["!", "?"],
      ["b", "B"],
      ["h", "H"],
      ["'", "\""],
      [";", ":"],
      [",", ")"]
    ],
    "row5": [[" "]]
  }
}
