{
  "keymapShowTopRow": false,
  "matrixShowRightColumn": true,
  "type": "iso",
  "keys": {
    "row1": [
      ["§", "½"],
      ["1", "!"],
      ["2", "\""],
      ["3", "#"],
      ["4", "¤"],
      ["5", "%"],
      ["6", "&"],
      ["7", "/"],
      ["8", "("],
      ["9", ")"],
      ["0", "="],
      ["+", "?"],
      ["´", "`"]
    ],
    "row2": [
      ["q", "Q"],
      ["w", "W"],
      ["f", "F"],
      ["p", "P"],
      ["g", "G"],
      ["j", "J"],
      ["l", "L"],
      ["u", "U"],
      ["y", "Y"],
      ["ö", "Ö"],
      ["å", "Å"],
      ["¨", "^"]
    ],
    "row3": [
      ["a", "A"],
      ["r", "R"],
      ["s", "S"],
      ["t", "T"],
      ["d", "D"],
      ["h", "H"],
      ["n", "N"],
      ["e", "E"],
      ["i", "I"],
      ["o", "O"],
      ["ä", "Ä"],
      ["'", "*"]
    ],
    "row4": [
      ["<", ">"],
      ["z", "Z"],
      ["x", "X"],
      ["c", "C"],
      ["v", "V"],
      ["b", "B"],
      ["k", "K"],
      ["m", "M"],
      [",", ";"],
      [".", ":"],
      ["-", "_"]
    ],
    "row5": [[" "]]
  }
}
