{
  "keymapShowTopRow": false,
  "type": "iso",
  "keys": {
    "row1": [
      ["§", "°"],
      ["1", "+"],
      ["2", "\""],
      ["3", "*"],
      ["4", "ç"],
      ["5", "%"],
      ["6", "&"],
      ["7", "/"],
      ["8", "("],
      ["9", ")"],
      ["0", "="],
      ["'", "?"],
      ["^", "`"]
    ],
    "row2": [
      ["q", "Q"],
      ["w", "W"],
      ["e", "E"],
      ["r", "R"],
      ["t", "T"],
      ["z", "Z"],
      ["u", "U"],
      ["i", "I"],
      ["o", "O"],
      ["p", "P"],
      ["è", "ü"],
      ["‥", "!"]
    ],
    "row3": [
      ["a", "A"],
      ["s", "S"],
      ["d", "D"],
      ["f", "F"],
      ["g", "G"],
      ["h", "H"],
      ["j", "J"],
      ["k", "K"],
      ["l", "L"],
      ["é", "ö"],
      ["à", "ä"],
      ["$", "£"]
    ],
    "row4": [
      ["<", ">"],
      ["y", "Y"],
      ["x", "X"],
      ["c", "C"],
      ["v", "V"],
      ["b", "B"],
      ["n", "N"],
      ["m", "M"],
      [",", ";"],
      [".", ":"],
      ["-", "_"]
    ],
    "row5": [[" "]]
  }
}
