{
  "keymapShowTopRow": false,
  "type": "ansi",
  "keys": {
    "row1": [
      ["`", "~"],
      ["1", "!"],
      ["2", "@"],
      ["3", "#"],
      ["4", "$"],
      ["5", "%"],
      ["6", "^"],
      ["7", "&"],
      ["8", "*"],
      ["9", "("],
      ["0", ")"],
      ["-", "_"],
      ["=", "+"]
    ],
    "row2": [
      ["q", "Q"],
      ["j", "J"],
      ["o", "O"],
      ["u", "U"],
      ["r", "R"],
      ["y", "Y"],
      ["m", "M"],
      ["p", "P"],
      ["w", "W"],
      ["v", "V"],
      ["[", "{"],
      ["]", "}"],
      ["\\", "|"]
    ],
    "row3": [
      ["z", "Z"],
      ["e", "E"],
      ["a", "A"],
      ["i", "I"],
      ["n", "N"],
      ["c", "C"],
      ["l", "L"],
      ["t", "T"],
      ["s", "S"],
      ["k", "K"],
      [";", ":"]
    ],
    "row4": [
      [";", ":"],
      ["x", "X"],
      [",", "<"],
      [".", ">"],
      ["f", "F"],
      ["g", "G"],
      ["h", "H"],
      ["d", "D"],
      ["b", "B"],
      ["'", "\""]
    ],
    "row5": [[" "]]
  }
}
