{
  "keymapShowTopRow": false,
  "type": "ansi",
  "keys": {
    "row1": [
      ["`", "~"],
      ["1", "!"],
      ["2", "@"],
      ["3", "#"],
      ["4", "$"],
      ["5", "%"],
      ["6", "^"],
      ["7", "&"],
      ["8", "*"],
      ["9", "("],
      ["0", ")"],
      ["-", "_"],
      ["=", "+"]
    ],
    "row2": [
      ["ஆ", "ஸ"],
      ["ஈ", "ஷ"],
      ["ஊ", "ஜ"],
      ["ஐ", "ஹ"],
      ["ஏ"],
      ["ள"],
      ["ற", "ஶ"],
      ["ன", ":"],
      ["ட", "["],
      ["ண", "]"],
      ["ச", "{"],
      ["ஞ", "}"],
      ["\\", "|"]
    ],
    "row3": [
      ["அ", "௹"],
      ["இ", "௺"],
      ["உ", "௸"],
      ["்", "ஃ"],
      ["எ", "எ"],
      ["க", "க"],
      ["ப", "ப"],
      ["ம", "\""],
      ["த", "௱"],
      ["ந", ";"],
      ["ய", "'"]
    ],
    "row4": [
      ["ஔ", "௳"],
      ["ஓ", "௴"],
      ["ஒ", "௵"],
      ["வ", "௶"],
      ["ங", "௷"],
      ["ல", "ௐ"],
      ["ர", "/"],
      [",", "<"],
      [".", ">"],
      ["ழ", "?"]
    ],
    "row5": [[" "]]
  }
}
