{
  "keymapShowTopRow": true,
  "type": "ansi",
  "keys": {
    "row1": [
      ["_", "%"],
      ["ๅ", "+"],
      ["/", "๑"],
      ["-", "๒"],
      ["ภ", "๓"],
      ["ถ", "๔"],
      ["ุ", "ู"],
      ["ึ", "฿"],
      ["ค", "๕"],
      ["ต", "๖"],
      ["จ", "๗"],
      ["ข", "๘"],
      ["ช", "๙"]
    ],
    "row2": [
      ["ๆ", "๐"],
      ["ไ", "\""],
      ["ำ", "ฎ"],
      ["พ", "ฑ"],
      ["ะ", "ธ"],
      ["ั", "ํ"],
      ["ี", "๊"],
      ["ร", "ณ"],
      ["น", "ฯ"],
      ["ย", "ญ"],
      ["บ", "ฐ"],
      ["ล", ","],
      ["ฃ", "ฅ"]
    ],
    "row3": [
      ["ฟ", "ฤ"],
      ["ห", "ฆ"],
      ["ก", "ฏ"],
      ["ด", "โ"],
      ["เ", "ฌ"],
      ["้", "็"],
      ["่", "๋"],
      ["า", "ษ"],
      ["ส", "ศ"],
      ["ว", "ซ"],
      ["ง", "."]
    ],
    "row4": [
      ["ผ", "("],
      ["ป", ")"],
      ["แ", "ฉ"],
      ["อ", "ฮ"],
      ["ิ", "ฺ"],
      ["ื", "์"],
      ["ท", "?"],
      ["ม", "ฒ"],
      ["ใ", "ฬ"],
      ["ฝ", "ฦ"]
    ],
    "row5": [[" "]]
  }
}
