{
  "keymapShowTopRow": true,
  "type": "ansi",
  "keys": {
    "row1": [
      ["`", "~"],
      ["1", "!"],
      ["2", "@"],
      ["3", "#"],
      ["4", "$"],
      ["5", "%"],
      ["6", "^"],
      ["7", "&"],
      ["8", "*"],
      ["9", "("],
      ["0", ")"],
      ["-", "_"],
      ["=", "+"]
    ],
    "row2": [
      ["ใ", "ฒ"],
      ["ต", "ฏ"],
      ["ห", "ซ"],
      ["ล", "ญ"],
      ["ส", "ฟ"],
      ["ป", "ฉ"],
      ["ั", "ึ"],
      ["ก", "ธ"],
      ["ิ", "ฐ"],
      ["บ", "ฎ"],
      ["็", "ฆ"],
      ["ฬ", "ฑ"],
      ["ฯ", "ฌ"]
    ],
    "row3": [
      ["ง", "ษ"],
      ["เ", "ถ"],
      ["ร", "แ"],
      ["น", "ช"],
      ["ม", "พ"],
      ["อ", "ผ"],
      ["า", "ำ"],
      ["่", "ข"],
      ["้", "โ"],
      ["ว", "ภ"],
      ["ื", "\""]
    ],
    "row4": [
      ["ุ", "ฤ"],
      ["ไ", "ฝ"],
      ["ท", "ๆ"],
      ["ย", "ณ"],
      ["จ", "๊"],
      ["ค", "๋"],
      ["ี", "์"],
      ["ด", "ศ"],
      ["ะ", "ฮ"],
      ["ู", "?"]
    ],
    "row5": [[" "]]
  }
}
