{
  "keymapShowTopRow": true,
  "type": "ansi",
  "keys": {
    "row1": [
      ["฿", "~"],
      ["ๅ", "+"],
      ["๒", "\""],
      ["๓", "/"],
      ["๔", ","],
      ["๕", "?"],
      ["ู", "ุ"],
      ["๗", "_"],
      ["๘", "."],
      ["๙", "("],
      ["๐", ")"],
      ["๑", "-"],
      ["๖", "%"]
    ],
    "row2": [
      ["็", "๊"],
      ["ต", "ฤ"],
      ["ย", "ๆ"],
      ["อ", "ญ"],
      ["ร", "ษ"],
      ["่", "ึ"],
      ["ด", "ฝ"],
      ["ม", "ซ"],
      ["ว", "ถ"],
      ["แ", "ฒ"],
      ["ใ", "ฯ"],
      ["ฌ", "ฦ"],
      ["ฃ", "ฅ"]
    ],
    "row3": [
      ["้", "๋"],
      ["ท", "ธ"],
      ["ง", "ำ"],
      ["ก", "ณ"],
      ["ั", "์"],
      ["ี", "ื"],
      ["า", "ผ"],
      ["น", "ช"],
      ["เ", "โ"],
      ["ไ", "ฆ"],
      ["ข", "ฑ"]
    ],
    "row4": [
      ["ฃ", "ฅ"],
      ["บ", "ฎ"],
      ["ป", "ฏ"],
      ["ล", "ฐ"],
      ["ห", "ภ"],
      ["ิ", "ั"],
      ["ค", "ศ"],
      ["ส", "ฮ"],
      ["ะ", "ฟ"],
      ["จ", "ฉ"]
    ],
    "row5": [[" "]]
  }
}
