{
  "keymapShowTopRow": false,
  "type": "iso",
  "keys": {
    "row1": [
      ["*", "+"],
      ["1", "!"],
      ["2", "\""],
      ["3", "^"],
      ["4", "$"],
      ["5", "%"],
      ["6", "&"],
      ["7", "'"],
      ["8", "("],
      ["9", ")"],
      ["0", "="],
      ["/", "?"],
      ["-", "_"]
    ],
    "row2": [
      ["q", "Q"],
      ["j", "J"],
      ["ü", "Ü"],
      ["o", "O"],
      ["f", "F"],
      ["c", "C"],
      ["t", "T"],
      ["m", "M"],
      ["k", "K"],
      ["b", "B"],
      ["s", "S"],
      ["p", "P"]
    ],
    "row3": [
      ["e", "E"],
      ["a", "A"],
      ["i", "İ"],
      ["ı", "I"],
      ["g", "G"],
      ["ğ", "Ğ"],
      ["l", "L"],
      ["n", "N"],
      ["r", "R"],
      ["d", "D"],
      ["v", "V"],
      [",", ";"]
    ],
    "row4": [
      ["<", ">"],
      ["x", "X"],
      ["w", "W"],
      ["ö", "Ö"],
      ["u", "U"],
      ["h", "H"],
      ["z", "Z"],
      ["ç", "Ç"],
      ["y", "Y"],
      ["ş", "Ş"],
      [".", ":"]
    ],
    "row5": [[" "]]
  }
}
