{
  "keymapShowTopRow": false,
  "type": "ansi",
  "keys": {
    "row1": [
      ["*", "+"],
      ["1", "!"],
      ["2", "\""],
      ["3", "^"],
      ["4", "$"],
      ["5", "%"],
      ["6", "&"],
      ["7", "'"],
      ["8", "("],
      ["9", ")"],
      ["0", "="],
      ["/", "?"],
      ["-", "_"]
    ],
    "row2": [
      ["f", "F"],
      ["g", "G"],
      ["ğ", "Ğ"],
      ["ı", "I"],
      ["o", "O"],
      ["d", "D"],
      ["r", "R"],
      ["n", "N"],
      ["h", "H"],
      ["p", "P"],
      ["q", "Q"],
      ["w", "W"],
      ["x", "X"]
    ],
    "row3": [
      ["u", "U"],
      ["i", "İ"],
      ["e", "E"],
      ["a", "A"],
      ["ü", "Ü"],
      ["t", "T"],
      ["k", "K"],
      ["m", "M"],
      ["l", "L"],
      ["y", "Y"],
      ["ş", "Ş"]
    ],
    "row4": [
      ["j", "J"],
      ["ö", "Ö"],
      ["v", "V"],
      ["c", "C"],
      ["ç", "Ç"],
      ["z", "Z"],
      ["s", "S"],
      ["b", "B"],
      [".", ":"],
      [",", ";"]
    ],
    "row5": [[" "]]
  }
}
