{
  "keymapShowTopRow": false,
  "type": "ansi",
  "keys": {
    "row1": [
      ["\"", "é"],
      ["1", "!"],
      ["2", "'"],
      ["3", "^"],
      ["4", "+"],
      ["5", "%"],
      ["6", "&"],
      ["7", "/"],
      ["8", "("],
      ["9", ")"],
      ["0", "="],
      ["*", "?"],
      ["-", "_"]
    ],
    "row2": [
      ["q", "Q"],
      ["w", "W"],
      ["e", "E"],
      ["r", "R"],
      ["t", "T"],
      ["y", "Y"],
      ["u", "U"],
      ["ı", "I"],
      ["o", "O"],
      ["p", "P"],
      ["ğ", "Ğ"],
      ["ü", "Ü"],
      [",", ";"]
    ],
    "row3": [
      ["a", "A"],
      ["s", "S"],
      ["d", "D"],
      ["f", "F"],
      ["g", "G"],
      ["h", "H"],
      ["j", "J"],
      ["k", "K"],
      ["l", "L"],
      ["ş", "Ş"],
      ["i", "İ"]
    ],
    "row4": [
      ["z", "Z"],
      ["x", "X"],
      ["c", "C"],
      ["v", "V"],
      ["b", "B"],
      ["n", "N"],
      ["m", "M"],
      ["ö", "Ö"],
      ["ç", "Ç"],
      [".", ":"]
    ],
    "row5": [[" "]]
  }
}
