{
  "keymapShowTopRow": false,
  "type": "ansi",
  "keys": {
    "row1": [
      ["^", "~"],
      ["1", "!"],
      ["2", "@"],
      ["3", "#"],
      ["4", "$"],
      ["5", "%"],
      ["6", "&"],
      ["7", "`"],
      ["8", "("],
      ["9", ")"],
      ["0", "="],
      ["*", "+"],
      ["\\", "|"]
    ],
    "row2": [
      ["j", "J"],
      ["g", "G"],
      ["h", "H"],
      ["p", "P"],
      ["f", "F"],
      ["q", "Q"],
      ["v", "V"],
      ["o", "O"],
      ["u", "U"],
      [";", ":"],
      ["/", "?"],
      ["[", "{"],
      ["]", "}"]
    ],
    "row3": [
      ["r", "R"],
      ["s", "S"],
      ["n", "N"],
      ["t", "T"],
      ["k", "K"],
      ["y", "Y"],
      ["i", "I"],
      ["a", "A"],
      ["e", "E"],
      ["l", "L"],
      ["-", "_"]
    ],
    "row4": [
      ["z", "Z"],
      ["w", "W"],
      ["m", "M"],
      ["d", "D"],
      ["b", "B"],
      ["c", "C"],
      [",", "<"],
      ["'", "\""],
      [".", ">"],
      ["x", "X"]
    ],
    "row5": [[" "]]
  }
}
