{
  "keymapShowTopRow": true,
  "type": "ansi",
  "keys": {
    "row1": [
      ["`", "~"],
      ["1", "!"],
      ["2", "@"],
      ["3", "#"],
      ["4", "$"],
      ["5", "%"],
      ["6", "^"],
      ["7", "&"],
      ["8", "*"],
      ["9", "("],
      ["0", ")"],
      ["[", "{"],
      ["]", "}"]
    ],
    "row2": [
      ["p", "P"],
      ["y", "Y"],
      ["u", "U"],
      ["o", "O"],
      ["-", "_"],
      ["k", "K"],
      ["d", "D"],
      ["h", "H"],
      ["f", "F"],
      ["x", "X"],
      ["q", "Q"],
      ["=", "+"],
      ["\\", "|"]
    ],
    "row3": [
      ["c", "C"],
      ["i", "I"],
      ["e", "E"],
      ["a", "A"],
      ["'", "/"],
      ["g", "G"],
      ["t", "T"],
      ["n", "N"],
      ["s", "S"],
      ["r", "R"],
      ["v", "V"]
    ],
    "row4": [
      ["z", "Z"],
      ["\"", "?"],
      [",", "<"],
      [".", ">"],
      [";", ":"],
      ["w", "W"],
      ["m", "M"],
      ["l", "L"],
      ["b", "B"],
      ["j", "J"]
    ],
    "row5": [[" "]]
  }
}
