{
  "keymapShowTopRow": false,
  "type": "ansi",
  "keys": {
    "row1": [
      ["?", "?"],
      ["1", "!"],
      ["2", "«"],
      ["3", "»"],
      ["4", "$"],
      ["5", "%"],
      ["6", "/"],
      ["7", "&"],
      ["8", "×"],
      ["9", "("],
      ["0", ")"],
      ["-", "_"],
      ["f", "F"]
    ],
    "row2": [
      ["ū", "Ū"],
      ["g", "G"],
      ["j", "J"],
      ["r", "R"],
      ["m", "M"],
      ["v", "V"],
      ["n", "N"],
      ["z", "Z"],
      ["ē", "Ē"],
      ["č", "Č"],
      ["ž", "Ž"],
      ["h", "H"],
      ["ķ", "Ķ"]
    ],
    "row3": [
      ["š", "Š"],
      ["u", "U"],
      ["s", "S"],
      ["i", "I"],
      ["l", "L"],
      ["d", "D"],
      ["a", "A"],
      ["t", "T"],
      ["e", "E"],
      ["c", "C"],
      ["'", "°"]
    ],
    "row4": [
      ["ņ", "Ņ"],
      ["b", "B"],
      ["ī", "Ī"],
      ["k", "K"],
      ["p", "P"],
      ["o", "O"],
      ["ā", "Ā"],
      [",", ";"],
      [".", ":"],
      ["ļ", "Ļ"]
    ],
    "row5": [[" "]]
  }
}
