{
  "keymapShowTopRow": true,
  "type": "ansi",
  "keys": {
    "row1": [
      ["؀", "ؔ"],
      ["۱", "!"],
      ["۲", "@"],
      ["۳", "#"],
      ["۴", "$"],
      ["۵", "٪"],
      ["۶", "^"],
      ["۷", "ٴ"],
      ["۸", "*"],
      ["۹", ")"],
      ["۰", "("],
      ["-", "_"],
      ["=", "+"]
    ],
    "row2": [
      ["ق", "ْ"],
      ["و", "ؤ"],
      ["ع", "ّ"],
      ["ر", "ڑ"],
      ["ت", "ٹ"],
      ["ے", "ٖ"],
      ["ئ", "ء"],
      ["ی", "ٰ"],
      ["ہ", "ۂ"],
      ["پ", "ٗ"],
      ["ُ", "ٌ"],
      ["َ", "ً"],
      ["ِ", "ٍ"]
    ],
    "row3": [
      ["ا", "آ"],
      ["س", "ص"],
      ["د", "ڈ"],
      ["ف"],
      ["گ", "غ"],
      ["ھ", "ح"],
      ["ج", "ض"],
      ["ک", "خ"],
      ["ل"],
      ["؛", ":"],
      ["'", "\""]
    ],
    "row4": [
      ["ز", "ذ"],
      ["ش", "ژ"],
      ["چ", "ث"],
      ["ط", "ظ"],
      ["ب"],
      ["ن", "ں"],
      ["م"],
      ["،", "٬"],
      ["۔", "."],
      ["/", "؟"]
    ],
    "row5": [[" "]]
  }
}
