{
  "keymapShowTopRow": false,
  "type": "ansi",
  "keys": {
    "row1": [
      ["\"", "'"],
      ["1", "!"],
      ["2", "@"],
      ["3", "#"],
      ["4", "$"],
      ["5", "%"],
      ["6", "^"],
      ["7", "&"],
      ["8", "*"],
      ["9", "("],
      ["0", ")"],
      ["-", "_"],
      ["=", "+"]
    ],
    "row2": [
      ["ц", "Ц"],
      ["д", "Д"],
      ["р", "Р"],
      ["г", "Г"],
      ["х", "Х"],
      ["ф", "Ф"],
      ["п", "П"],
      ["а", "А"],
      ["я", "Я"],
      ["э", "Э"],
      [",", ";"],
      [".", ":"],
      ["\\", "|"]
    ],
    "row3": [
      ["с", "С"],
      ["т", "Т"],
      ["н", "Н"],
      ["к", "К"],
      ["б", "Б"],
      ["ь", "Ь", "ъ", "Ъ"],
      ["в", "В"],
      ["о", "О"],
      ["е", "Е", "ё", "Ё"],
      ["и", "И"],
      [".", ":"]
    ],
    "row4": [
      ["ш", "Ш", "щ", "Щ"],
      ["з", "З"],
      ["л", "Л"],
      ["м", "М"],
      ["ч", "Ч"],
      ["ж", "Ж"],
      ["й", "Й"],
      ["ы", "Ы"],
      ["у", "У"],
      ["ю", "Ю"]
    ],
    "row5": [[" "]]
  }
}
