{
  "keymapShowTopRow": false,
  "type": "ansi",
  "keys": {
    "row1": [
      ["`", "~"],
      ["1", "!"],
      ["2", "@"],
      ["3", "#"],
      ["4", "$"],
      ["5", "%"],
      ["6", "^"],
      ["7", "&"],
      ["8", "*"],
      ["9", "("],
      ["0", ")"],
      ["-", "_"],
      ["=", "+"]
    ],
    "row2": [
      ["t", "T"],
      ["k", "K"],
      ["v", "V"],
      ["u", "U"],
      ["m", "M"],
      ["i", "I"],
      ["a", "A"],
      ["j", "J"],
      ["b", "B"],
      ["r", "R"],
      ["[", "{"],
      ["]", "}"],
      ["\\", "|"]
    ],
    "row3": [
      ["w", "W"],
      ["x", "X"],
      ["/", "?"],
      ["f", "F"],
      ["p", "P"],
      ["d", "D"],
      ["g", "G"],
      ["q", "Q"],
      [",", "<"],
      ["s", "S"],
      [";", ":"]
    ],
    "row4": [
      ["h", "H"],
      [".", ">"],
      ["'", "\""],
      ["c", "C"],
      ["o", "O"],
      ["l", "L"],
      ["n", "N"],
      ["z", "Z"],
      ["y", "Y"],
      ["e", "E"]
    ],
    "row5": [[" "]]
  }
}
