{
  "keymapShowTopRow": false,
  "type": "ansi",
  "keys": {
    "row1": [
      ["`", "~"],
      ["1", "!"],
      ["2", "@"],
      ["3", "#"],
      ["4", "$"],
      ["5", "%"],
      ["6", "^"],
      ["7", "&"],
      ["8", "*"],
      ["9", "("],
      ["0", ")"],
      ["[", "{"],
      ["]", "}"]
    ],
    "row2": [
      ["w", "W"],
      ["c", "C"],
      ["m", "M"],
      ["p", "P"],
      ["k", "K"],
      ["x", "X"],
      ["l", "L"],
      ["o", "O"],
      ["u", "U"],
      ["j", "J"],
      ["-", "_"],
      ["=", "+"],
      ["\\", "|"]
    ],
    "row3": [
      ["r", "R"],
      ["s", "S"],
      ["t", "T"],
      ["h", "H"],
      ["f", "F"],
      ["'", "\""],
      ["n", "N"],
      ["a", "A"],
      ["e", "E"],
      ["i", "I"],
      ["/", "?"]
    ]
    "row4": [
      ["q", "Q"],
      ["g", "G"],
      ["v", "V"],
      ["d", "D"],
      ["b", "B"],
      ["z", "Z"],
      ["y", "Y"],
      [".", "<"],
      [";", ":"],
      [",", ">"]
    ],
    "row5": [[" "]]
  }
}
