{
  "keymapShowTopRow": false,
  "type": "ansi",
  "keys": {
    "row1": [
      ["`", "~"],
      ["1", "!"],
      ["2", "@"],
      ["3", "#"],
      ["4", "$"],
      ["5", "%"],
      ["6", "^"],
      ["7", "&"],
      ["8", "*"],
      ["9", "("],
      ["0", ")"],
      ["[", "{"],
      ["]", "}"]
    ],
    "row2": [
      ["w", "W"],
      ["c", "C"],
      ["m", "M"],
      ["p", "P"],
      ["b", "B"],
      ["x", "X"],
      ["l", "L"],
      ["o", "O"],
      ["u", "U"],
      ["j", "J"],
      ["-", "_"],
      ["=", "+"],
      ["\\", "|"]
    ],
    "row3": [
      ["r", "R"],
      ["s", "S"],
      ["t", "T"],
      ["h", "H"],
      ["f", "F"],
      ["y", "Y"],
      ["n", "N"],
      ["a", "A"],
      ["e", "E"],
      ["i", "I"],
      [",", ">"]
    ],
    "row4": [
      ["q", "Q"],
      ["v", "V"],
      ["g", "G"],
      ["d", "D"],
      ["k", "K"],
      ["z", "Z"],
      ["/", "?"],
      ["'", "\""],
      [";", ":"],
      [".", "<"]
    ],
    "row5": [[" "]]
  }
}
