{
  "keymapShowTopRow": false,
  "type": "ansi",
  "keys": {
    "row1": [
      ["1", "!"],
      ["2", "@"],
      ["3", "#"],
      ["4", "$"],
      ["5", "%"],
      ["6", "^"],
      ["7", "&"],
      ["8", "*"],
      ["9", "("],
      ["0", ")"],
      [" "],
      [" "],
      [" "]
    ],
    "row2": [
      ["b", "B"],
      ["l", "L"],
      ["n", "N"],
      ["d", "D"],
      ["k", "K"],
      ["'", "\""],
      ["f", "F"],
      ["o", "O"],
      ["u", "U"],
      ["j", "J"],
      [" "],
      [" "],
      [" "]
    ],
    "row3": [
      ["s", "S"],
      ["h", "H"],
      ["r", "R"],
      ["t", "T"],
      ["w", "W"],
      ["y", "Y"],
      ["c", "C"],
      ["a", "A"],
      ["e", "E"],
      ["i", "I"],
      [" "]
    ],
    "row4": [
      ["q", "Q"],
      ["x", "X"],
      ["m", "M"],
      ["v", "V"],
      ["z", "Z"],
      ["p", "P"],
      ["g", "G"],
      [",", "<"],
      [".", ">"],
      ["/", "?"]
    ],
    "row5": [[" "]]
  }
}
