{
  "keymapShowTopRow": false,
  "type": "ansi",
  "keys": {
    "row1": [
      ["`", "~"],
      ["1", "!"],
      ["2", "@"],
      ["3", "#"],
      ["4", "$"],
      ["5", "%"],
      ["6", "^"],
      ["7", "&"],
      ["8", "*"],
      ["9", "("],
      ["0", ")"],
      ["[", "{"],
      ["]", "}"]
    ],
    "row2": [
      ["f", "F"],
      ["l", "L"],
      ["h", "H"],
      ["y", "Y"],
      ["k", "K"],
      ["q", "Q"],
      ["w", "W"],
      ["o", "O"],
      ["u", "U"],
      [",", "<"],
      ["-", "_"],
      ["=", "+"],
      ["\\", "|"]
    ],
    "row3": [
      ["s", "S"],
      ["r", "R"],
      ["n", "N"],
      ["t", "T"],
      ["p", "P"],
      ["c", "C"],
      ["d", "D"],
      ["a", "A"],
      ["e", "E"],
      ["i", "I"],
      ["/", "?"]
    ],
    "row4": [
      ["x", "X"],
      ["j", "J"],
      ["b", "B"],
      ["v", "V"],
      ["z", "Z"],
      ["m", "M"],
      ["g", "G"],
      ["'", "\""],
      [";", ":"],
      [".", ">"]
    ],
    "row5": [[" "]]
  }
}
