{
  "keymapShowTopRow": false,
  "type": "ansi",
  "keys": {
    "row1": [
      ["`", "~"],
      ["1", "!"],
      ["2", "@"],
      ["3", "#"],
      ["4", "$"],
      ["5", "%"],
      ["6", "^"],
      ["7", "&"],
      ["8", "*"],
      ["9", "("],
      ["0", ")"],
      ["-", "_"],
      ["=", "+"]
    ],
    "row2": [
      ["q", "Q"],
      ["g", "G"],
      ["d", "D"],
      ["f", "F"],
      ["v", "V"],
      ["j", "J"],
      ["l", "L"],
      ["u", "U"],
      ["o", "O"],
      [",", "<"],
      ["[", "{"],
      ["]", "}"],
      ["\\", "|"]
    ],
    "row3": [
      ["n", "N"],
      ["s", "S"],
      ["t", "T"],
      ["h", "H"],
      ["y", "Y"],
      ["w", "W"],
      ["r", "R"],
      ["e", "E"],
      ["a", "A"],
      ["i", "I"],
      [";", ":"]
    ],
    "row4": [
      ["b", "B"],
      ["c", "C"],
      ["m", "M"],
      ["p", "P"],
      ["k", "K"],
      ["z", "Z"],
      ["x", "X"],
      ["/", "?"],
      ["'", "\""],
      [".", ">"]
    ],
    "row5": [[" "]]
  }
}
