{
  "keymapShowTopRow": false,
  "type": "ansi",
  "keys": {
    "row1": [
      ["`", "~"],
      ["1", "!"],
      ["2", "@"],
      ["3", "#"],
      ["4", "$"],
      ["5", "%"],
      ["6", "^"],
      ["7", "&"],
      ["8", "*"],
      ["9", "("],
      ["0", ")"],
      ["-", "_"],
      ["=", "+"]
    ],
    "row2": [
      [",", "<"],
      ["o", "O"],
      ["u", "U"],
      ["r", "R"],
      ["q", "Q"],
      ["j", "J"],
      ["f", "F"],
      ["d", "D"],
      ["v", "V"],
      ["g", "G"],
      ["[", "{"],
      ["]", "}"],
      ["\\", "|"]
    ],
    "row3": [
      ["i", "I"],
      ["a", "A"],
      ["e", "E"],
      ["n", "N"],
      ["x", "X"],
      ["y", "Y"],
      ["h", "H"],
      ["t", "T"],
      ["s", "S"],
      ["c", "C"],
      ["/", "?"]
    ],
    "row4": [
      [".", ">"],
      ["'", "\""],
      [";", ":"],
      ["l", "L"],
      ["z", "Z"],
      ["k", "K"],
      ["p", "P"],
      ["m", "M"],
      ["b", "B"],
      ["w", "W"]
    ],
    "row5": [[" "]]
  }
}
