{
  "keymapShowTopRow": false,
  "type": "ansi",
  "keys": {
    "row1": [
      ["`", "~"],
      ["1", "!"],
      ["2", "@"],
      ["3", "#"],
      ["4", "$"],
      ["5", "%"],
      ["6", "^"],
      ["7", "&"],
      ["8", "*"],
      ["9", "("],
      ["0", ")"],
      ["-", "_"],
      ["=", "+"]
    ],
    "row2": [
      ["g", "G"],
      ["v", "V"],
      ["d", "D"],
      ["f", "F"],
      ["j", "J"],
      ["q", "Q"],
      ["r", "R"],
      ["u", "U"],
      ["o", "O"],
      ["'", "\""],
      ["[", "{"],
      ["]", "}"],
      ["\\", "|"]
    ],
    "row3": [
      ["c", "C"],
      ["s", "S"],
      ["t", "T"],
      ["h", "H"],
      ["y", "Y"],
      ["l", "L"],
      ["n", "N"],
      ["e", "E"],
      ["a", "A"],
      ["i", "I"],
      [";", ":"]
    ],
    "row4": [
      ["w", "W"],
      ["b", "B"],
      ["m", "M"],
      ["p", "P"],
      ["k", "K"],
      ["z", "Z"],
      ["x", "X"],
      [",", "<"],
      [".", ">"],
      ["/", "?"]
    ],
    "row5": [[" "]]
  }
}
