{
  "keymapShowTopRow": false,
  "type": "ansi",
  "keys": {
    "row1": [
      ["`", "~"],
      ["1", "!"],
      ["2", "@"],
      ["3", "#"],
      ["4", "$"],
      ["5", "%"],
      ["6", "^"],
      ["7", "&"],
      ["8", "*"],
      ["9", "("],
      ["0", ")"],
      ["-", "_"],
      ["=", "+"]
    ],
    "row2": [
      ["f", "F"],
      ["o", "O"],
      ["u", "U"],
      ["r", "R"],
      ["z", "Z"],
      ["w", "W"],
      ["v", "V"],
      ["j", "J"],
      ["l", "L"],
      ["d", "D"],
      ["[", "{"],
      ["]", "}"],
      ["\\", "|"]
    ],
    "row3": [
      ["y", "Y"],
      ["a", "A"],
      ["i", "I"],
      ["n", "N"],
      ["c", "C"],
      ["g", "G"],
      ["s", "S"],
      ["e", "E"],
      ["h", "H"],
      ["t", "T"],
      ["/", "?"]
    ],
    "row4": [
      ["'", "\""],
      [".", ">"],
      [",", "<"],
      ["b", "B"],
      ["x", "X"],
      ["m", "M"],
      ["p", "P"],
      ["q", "Q"],
      ["k", "K"],
      [";", ":"]
    ],
    "row5": [[" "]]
  }
}
