{
  "keymapShowTopRow": true,
  "type": "ansi",
  "keys": {
    "row1": [
      ["ё", "Ё"],
      ["1", "!"],
      ["2", "\""],
      ["3", "№"],
      ["4", ";"],
      ["5", "%"],
      ["6", ":"],
      ["7", "?"],
      ["8", "*"],
      ["9", "("],
      ["0", ")"],
      ["-", "_"],
      ["=", "+"]
    ],
    "row2": [
      ["ф", "Ф"],
      ["ы", "Ы"],
      ["а", "А"],
      ["я", "Я"],
      [",", "Ъ"],
      ["й", "Й"],
      ["м", "М"],
      ["р", "Р"],
      ["п", "П"],
      ["х", "Х"],
      ["ц", "Ц"],
      ["щ", "Щ"],
      ["\\", "/"]
    ],
    "row3": [
      ["г", "Г"],
      ["и", "И"],
      ["е", "Е"],
      ["о", "О"],
      ["у", "У"],
      ["л", "Л"],
      ["т", "Т"],
      ["с", "С"],
      ["н", "Н"],
      ["з", "З"],
      ["ж", "Ж"]
    ],
    "row4": [
      ["ш", "Ш"],
      ["ь", "ъ"],
      ["ю", "Ю"],
      [".", "Ь"],
      ["э", "Э"],
      ["б", "Б"],
      ["д", "Д"],
      ["в", "В"],
      ["к", "К"],
      ["ч", "Ч"]
    ],
    "row5": [[" "]]
  }
}
